"spec","Osobní nálezy","ČBFS","Bryonora (M)","ČNFD","NDOP","total","RL_eval"
"Polytrichum formosum",0,35,0,5720,28585,34340,"LC"
"Dicranum scoparium",0,80,0,4542,25797,30419,"LC"
"Pleurozium schreberi",0,3,0,3912,21245,25160,"LC"
"Hypnum cupressiforme",0,9,0,4916,16038,20963,"NE"
"Sphagnum",0,3,0,1225,15838,17066,""
"Polytrichum commune",0,17,0,2956,10064,13037,"LC"
"Plagiomnium affine",0,15,0,4532,8438,12985,"LC"
"Atrichum undulatum",0,7,0,2786,7659,10452,"LC"
"Pohlia nutans",0,53,0,2615,7485,10153,"NE"
"Leucobryum glaucum",0,3,0,659,7691,8353,"LC"
"Hylocomium splendens",0,1,0,1277,6831,8109,"LC"
"Sphagnum girgensohnii",0,16,0,1318,6067,7401,"LC"
"Dicranella heteromalla",0,32,0,1881,5097,7010,"LC"
"Bazzania trilobata",0,0,0,599,6373,6972,"LC"
"Dicranum polysetum",0,5,0,859,5661,6525,"LC"
"Plagiomnium undulatum",0,3,0,2091,3434,5528,"LC"
"Sphagnum fallax",0,24,0,1802,3551,5377,"LC"
"Brachythecium rutabulum",0,18,0,3224,1845,5087,"LC"
"Ceratodon purpureus",0,35,0,2888,1912,4835,"LC"
"Rhytidiadelphus squarrosus",0,4,0,3086,1650,4740,"LC"
"Calliergonella cuspidata",0,53,0,3297,1184,4534,"LC"
"Rhizomnium punctatum",0,17,0,1332,2756,4105,"LC"
"Plagiothecium laetum",0,19,0,903,3128,4050,"LC"
"Aulacomnium palustre",0,12,0,2603,1390,4005,"LC"
"Climacium dendroides",0,5,0,3020,897,3922,"LC"
"Mnium hornum",0,6,0,628,3055,3689,"LC"
"Thuidium tamariscinum",0,5,0,496,2601,3102,"LC"
"Sphagnum palustre",0,96,0,1079,1811,2986,"LC"
"Plagiothecium undulatum",0,1,0,344,2482,2827,"LC"
"Plagiothecium",0,0,0,690,2117,2807,""
"Polytrichum juniperinum",0,1,0,672,2090,2763,"LC"
"Sphagnum russowii",0,12,0,693,2049,2754,"LC"
"Brachythecium rivulare",0,44,0,1419,1279,2742,"LC"
"Sphagnum capillifolium",0,9,0,956,1666,2631,"LC"
"Plagiothecium denticulatum",0,23,0,998,1570,2591,"NE"
"Brachytheciastrum velutinum",0,26,0,793,1765,2584,"LC"
"Tetraphis pellucida",0,22,0,652,1838,2512,"LC"
"Oxyrrhynchium hians",0,12,0,1754,696,2462,"LC"
"Lepidozia reptans",0,11,0,347,2078,2436,"LC"
"Polytrichum piliferum",0,15,0,1331,1008,2354,"LC"
"Abietinella abietina",0,6,0,1690,573,2269,"NE"
"Eurhynchium striatum",0,5,0,192,1995,2192,"LC-att"
"Lophocolea heterophylla",0,30,0,465,1605,2100,"LC"
"Dicranum montanum",0,36,0,215,1755,2006,"LC"
"Polytrichum strictum",0,6,0,1297,699,2002,"LC"
"Straminergon stramineum",0,24,0,1371,534,1929,"LC"
"Dicranodontium denudatum",0,31,0,391,1364,1786,"LC"
"Brachythecium",0,2,0,1240,508,1750,""
"Polytrichum",0,0,0,232,1506,1738,""
"Amblystegium serpens",0,41,0,378,1315,1734,"LC"
"Plagiomnium cuspidatum",0,3,0,576,1140,1719,"LC"
"Ptilidium ciliare",0,5,0,497,1215,1717,"LC"
"Mnium",0,0,0,503,1167,1670,""
"Bryum pseudotriquetrum",0,43,0,1222,392,1657,"NE"
"Mnium spinosum",0,8,0,72,1574,1654,"LC"
"Brachythecium salebrosum",0,18,0,356,1260,1634,"LC"
"Rhytidiadelphus triquetrus",0,1,0,627,941,1569,"LC"
"Cirriphyllum piliferum",0,3,0,1157,379,1539,"LC"
"Bryum argenteum",0,15,0,1069,450,1534,"LC"
"Sphagnum teres",0,17,0,899,618,1534,"LC"
"Plagiochila asplenioides",0,4,0,425,1079,1508,"LC"
"Sphagnum magellanicum",0,8,0,805,692,1505,"LC"
"Sphagnum flexuosum",0,35,0,894,541,1470,"LC"
"Sphagnum squarrosum",0,6,0,488,961,1455,"LC"
"Hamatocaulis vernicosus",0,132,19,256,1039,1446,"VU"
"Campylium stellatum",0,77,0,1001,344,1422,"NT"
"Cephalozia bicuspidata",0,112,0,386,898,1396,"LC"
"Paraleucobryum longifolium",0,18,0,370,992,1380,"LC"
"Syntrichia ruralis",0,30,0,841,473,1344,"NE"
"Homalothecium lutescens",0,8,0,977,342,1327,"LC"
"Herzogiella seligeri",0,9,0,167,1075,1251,"LC"
"Fontinalis antipyretica",0,2,0,222,993,1217,"LC"
"Plagiochila porelloides",0,35,0,304,877,1216,"LC"
"Pseudoscleropodium purum",0,1,0,525,676,1202,"LC"
"Plagiothecium curvifolium",0,8,0,181,971,1160,"LC"
"Brachythecium albicans",0,3,0,795,333,1131,"LC"
"Bryum",0,17,0,745,354,1116,""
"Pohlia nutans subsp. nutans",0,0,1,0,1086,1087,"LC"
"Fissidens taxifolius",0,5,0,659,409,1073,"LC"
"Eurhynchium angustirete",0,4,0,415,631,1050,"LC"
"Leucobryum juniperoideum",0,6,0,27,1011,1044,"LC"
"Isothecium alopecuroides",0,11,0,204,826,1041,"LC"
"Marchantia polymorpha",0,0,0,243,795,1038,"NE"
"Plagiomnium elatum",0,22,0,742,254,1018,"LC-att"
"Bryum moravicum",0,16,0,59,940,1015,"LC"
"Sphagnum cuspidatum",0,9,0,577,366,952,"LC"
"Homalothecium sericeum",0,23,0,391,502,916,"LC"
"Calypogeia azurea",0,26,0,277,611,914,"LC"
"Sanionia uncinata",0,36,0,121,740,897,"LC"
"Metzgeria furcata",0,25,0,27,839,891,"LC"
"Tortella tortuosa",0,33,0,518,338,889,"LC"
"Sphagnum warnstorfii",0,48,0,489,339,876,"LC-att"
"Sciuro-hypnum reflexum",0,27,0,140,699,866,"LC"
"Ptilidium pulcherrimum",0,5,0,146,703,854,"LC"
"Platygyrium repens",0,14,0,8,825,847,"LC"
"Tomentypnum nitens",0,31,0,563,246,840,"NT"
"Dicranum viride",0,42,34,1,760,837,"NT"
"Rhytidiadelphus loreus",0,3,0,193,634,830,"LC"
"Bryum capillare",0,18,0,269,523,810,"LC"
"Dicranum",0,1,0,109,699,809,""
"Hypnum cupressiforme var. cupressiforme",0,26,0,19,760,805,"LC"
"Lophocolea coadunata",0,0,0,1,793,794,"LC"
"Rhytidium rugosum",0,5,0,621,163,789,"LC"
"Lophocolea bidentata",0,5,0,746,37,788,"LC-att"
"Scapania undulata",0,30,0,211,545,786,"LC"
"Calliergon cordifolium",0,19,0,325,419,763,"LC"
"Lophozia ventricosa",0,25,0,207,515,747,"LC"
"Sphagnum papillosum",0,66,0,423,245,734,"LC"
"Warnstorfia fluitans",0,15,0,488,230,733,"LC"
"Plagiothecium cavifolium",0,27,0,292,410,729,"LC"
"Palustriella commutata",0,23,0,383,281,687,"LC"
"Pellia epiphylla",0,9,0,221,451,681,"LC"
"Sphagnum rubellum",0,9,0,403,243,655,"LC"
"Pterigynandrum filiforme",0,13,0,27,608,648,"LC"
"Sciuro-hypnum populeum",0,14,0,127,503,644,"LC"
"Calypogeia muelleriana",0,26,0,136,475,637,"LC"
"Radula complanata",0,20,0,10,606,636,"LC"
"Tortula muralis",0,0,0,293,341,634,"NE"
"Fissidens adianthoides",0,33,0,443,157,633,"LC-att"
"Mnium spinulosum",0,2,0,49,580,631,"LC"
"Cynodontium polycarpon",0,52,0,153,425,630,"LC"
"Pylaisia polyantha",0,18,0,8,599,625,"LC"
"Riccia fluitans",0,3,0,342,267,612,"LC"
"Aneura pinguis",0,33,0,341,231,605,"LC"
"Philonotis fontana",0,36,0,324,243,603,"LC"
"Fissidens dubius",0,25,0,394,183,602,"NE"
"Racomitrium canescens",0,13,0,278,303,594,"LC"
"Chiloscyphus polyanthos",0,5,0,294,284,583,"LC"
"Porella platyphylla",0,7,0,148,426,581,"LC"
"Calypogeia integristipula",0,9,0,149,420,578,"LC"
"Conocephalum conicum",0,8,0,204,362,574,"LC"
"Plagiothecium succulentum",0,21,0,275,274,570,"LC"
"Hedwigia ciliata",0,6,0,181,372,559,"LC"
"Sphagnum contortum",0,63,0,386,106,555,"NT"
"Cratoneuron filicinum",0,12,0,300,237,549,"LC"
"Grimmia pulvinata",0,20,0,254,269,543,"LC"
"Barbilophozia lycopodioides",0,4,0,312,222,538,"LC"
"Breidleria pratensis",0,25,0,290,219,534,"LC-att"
"Sarmentypnum exannulatum",0,45,0,346,143,534,"LC"
"Anomodon attenuatus",0,11,0,114,405,530,"LC"
"Drepanocladus aduncus",0,30,0,391,107,528,"LC"
"Racomitrium sudeticum",0,159,0,111,254,524,"LC"
"Sphagnum fimbriatum",0,9,0,228,277,514,"LC"
"Encalypta streptocarpa",0,20,0,202,290,512,"LC"
"Barbula unguiculata",0,23,0,200,285,508,"LC"
"Anomodon viticulosus",0,13,0,117,376,506,"LC"
"Pellia neesiana",0,9,0,146,351,506,"LC"
"Calliergon giganteum",0,43,9,172,281,505,"VU"
"Alleniella complanata",0,8,0,142,348,498,"LC"
"Blepharostoma trichophyllum",0,37,0,36,425,498,"LC"
"Scapania nemorea",0,11,0,163,323,497,"LC"
"Schistidium apocarpum",0,53,0,151,292,496,"LC"
"Pseudoleskeella nervosa",0,25,0,13,453,491,"LC"
"Pellia",0,3,0,415,72,490,""
"Plagiomnium ellipticum",0,25,0,194,271,490,"LC-att"
"Sphagnum riparium",0,1,0,149,335,485,"LC"
"Ctenidium molluscum",0,23,0,202,259,484,"LC"
"Plagiomnium rostratum",0,5,0,338,140,483,"LC"
"Plagiomnium",0,0,0,284,193,477,""
"Sphagnum subsecundum",0,51,0,303,123,477,"LC"
"Thuidium assimile",0,11,0,283,182,476,"LC"
"Gymnocolea inflata",0,37,0,275,161,473,"LC"
"Eurhynchium",0,0,0,191,280,471,""
"Barbilophozia barbata",0,8,0,173,282,463,"LC"
"Campyliadelphus chrysophyllus",0,12,0,349,88,449,"LC"
"Orthotrichum stramineum",0,66,0,0,381,447,"LC"
"Orthotrichum pumilum",0,44,0,0,394,438,"LC"
"Thuidium delicatulum",0,10,0,306,117,433,"LC-att"
"Buxbaumia viridis",0,6,35,0,381,422,"VU"
"Leptodictyum riparium",0,11,0,315,95,421,"LC"
"Funaria hygrometrica",0,2,0,132,284,418,"LC"
"Orthotrichum anomalum",39,18,0,73,288,418,"LC"
"Orthotrichum diaphanum",108,18,0,2,287,415,"LC"
"Dicranum fuscescens",0,3,0,185,226,414,"LC"
"Lewinskya speciosa",0,44,0,0,369,413,"LC"
"Pseudotaxiphyllum elegans",0,16,0,91,303,410,"LC"
"Frullania dilatata",0,19,0,28,345,392,"LC"
"Polytrichum longisetum",0,16,0,162,205,383,"LC"
"Ricciocarpos natans",0,2,0,221,148,371,"NT"
"Ptilium crista-castrensis",0,8,0,33,323,364,"LC-att"
"Hypnum andoi",0,31,0,2,330,363,"LC"
"Rhodobryum roseum",0,7,0,132,224,363,"LC"
"Cephaloziella divaricata",0,88,0,48,226,362,"LC"
"Dicranella",0,9,0,66,284,359,""
"Mylia taylorii",0,8,0,57,294,359,"LC"
"Bryum caespiticium",0,19,0,231,107,357,"LC"
"Flexitrichum flexicaule",0,8,0,267,79,354,"LC"
"Diplophyllum albicans",0,27,0,82,244,353,"LC"
"Leucodon sciuroides",0,14,0,26,313,353,"LC"
"Mnium stellare",0,14,0,93,244,351,"LC"
"Mylia anomala",0,7,0,195,149,351,"LC"
"Scorpidium cossonii",0,65,0,176,110,351,"NT"
"Barbilophozia sudetica",0,109,0,51,188,348,"LC"
"Sciuro-hypnum starckii",0,33,0,96,219,348,"LC"
"Dicranum bonjeanii",0,25,1,228,93,347,"NT"
"Chiloscyphus pallescens",0,26,0,56,262,344,"LC-att"
"Racomitrium",0,0,0,133,207,340,""
"Pseudocampylium radicale",0,40,0,112,186,338,"LC-att"
"Tortula acaulon",0,16,0,211,111,338,"NE"
"Homalia trichomanoides",0,6,0,37,291,334,"LC"
"Racomitrium heterostichum",0,17,0,140,177,334,"LC"
"Plagiothecium nemorale",0,13,0,1,313,327,"LC"
"Andreaea rupestris",0,55,0,41,228,324,"LC"
"Calypogeia neesiana",0,19,0,96,208,323,"LC"
"Grimmia hartmanii",0,49,0,46,225,320,"LC"
"Scapania irrigua",0,65,0,45,208,318,"LC"
"Rhynchostegium riparioides",0,5,0,62,250,317,"LC"
"Neoorthocaulis attenuatus",0,5,0,69,239,313,"LC"
"Sphagnum fuscum",0,3,3,111,196,313,"NT"
"Brachythecium mildeanum",0,18,0,181,112,311,"LC-att"
"Isothecium myosuroides",0,11,1,97,200,309,"LC-att"
"Thuidium recognitum",0,17,0,198,89,304,"LC"
"Philonotis seriata",0,16,0,172,115,303,"LC"
"Bryoerythrophyllum recurvirostrum",0,44,0,46,210,300,"LC"
"Dichodontium pellucidum",0,11,0,134,154,299,"LC"
"Scorpidium revolvens",0,7,4,268,18,297,"EN"
"Sphagnum auriculatum",0,31,0,130,134,295,"LC"
"Hypnum",0,0,0,145,146,291,""
"Schistochilopsis incisa",0,16,0,28,242,286,"LC"
"Dicranella cerviculata",0,8,0,54,223,285,"LC"
"Paludella squarrosa",0,7,10,98,167,282,"EN"
"Riccia rhenana",0,0,5,205,70,280,"NT"
"Exsertotheca crispa",0,0,0,128,150,278,"LC"
"Hypnum pallescens",0,24,3,11,234,272,"LC-att"
"Pogonatum urnigerum",0,4,0,61,207,272,"LC"
"Nowellia curvifolia",0,29,0,1,239,269,"LC-att"
"Fuscocephaloziopsis lunulifolia",0,24,0,55,189,268,"LC"
"Orthotrichum pallens",3,51,0,0,214,268,"LC"
"Aulacomnium androgynum",0,3,0,43,217,263,"LC"
"Ulota bruchii",0,16,0,1,238,255,"LC"
"Sphagnum majus",0,3,0,131,119,253,"LC"
"Riccardia latifrons",0,23,0,8,220,251,"LC-att"
"Thuidium",0,0,0,95,155,250,""
"Leptobryum pyriforme",0,6,0,177,66,249,"LC"
"Polytrichastrum alpinum",0,21,0,97,129,247,"LC"
"Dichodontium palustre",0,11,0,127,108,246,"LC-att"
"Calypogeia",0,1,0,71,173,245,""
"Heterocladium heteropterum",0,9,0,30,205,244,"LC"
"Pohlia wahlenbergii",0,17,0,69,158,244,"LC"
"Pellia endiviifolia",0,12,0,67,164,243,"LC"
"Sphagnum subnitens",0,36,0,93,112,241,"LC-att"
"Brachythecium glareosum",0,11,0,138,90,239,"LC"
"Orthodontium lineare",0,14,0,22,202,238,"LC"
"Sphagnum quinquefarium",0,4,0,61,164,229,"LC"
"Rhynchostegium murale",0,15,0,50,163,228,"LC"
"Tortella inclinata",0,11,0,171,46,228,"LC"
"Lophozia",0,0,0,51,176,227,""
"Diplophyllum obtusifolium",0,20,1,3,202,226,"LC"
"Kindbergia praelonga",0,11,0,78,137,226,"LC"
"Rhabdoweisia fugax",0,36,0,16,174,226,"LC"
"Nardia scalaris",0,38,0,14,173,225,"LC"
"Sphenolobus minutus",0,18,0,9,198,225,"LC"
"Anastrepta orcadensis",0,23,0,38,162,223,"LC-att"
"Plagiomnium medium",0,19,0,87,117,223,"NT"
"Thamnobryum alopecurum",0,6,0,43,173,222,"LC"
"Homomallium incurvatum",0,4,0,26,191,221,"LC"
"Sphagnum tenellum",0,2,0,131,88,221,"LC"
"Dicranum tauricum",0,14,0,21,184,219,"LC"
"Fuscocephaloziopsis connivens",0,21,0,48,150,219,"LC"
"Tortula truncata",0,12,0,61,145,218,"LC"
"Bartramia pomiformis",0,4,0,81,130,215,"LC"
"Leucobryum",0,0,0,12,203,215,""
"Sciuro-hypnum curtum",0,25,0,35,155,215,"LC"
"Schistidium crassipilum",0,46,0,0,167,213,"LC"
"Sphagnum compactum",0,9,0,99,103,211,"LC"
"Lejeunea cavifolia",0,16,0,17,176,209,"LC"
"Neoorthocaulis floerkei",0,5,0,121,83,209,"LC"
"Polytrichum pallidisetum",0,11,1,61,132,205,"LC-att"
"Riccia cavernosa",0,0,6,143,55,204,"NT"
"Lewinskya affinis var. affinis",202,0,0,0,0,202,"LC"
"Scapania umbrosa",0,11,0,4,187,202,"LC"
"Polytrichum uliginosum",0,20,0,0,181,201,"LC-att"
"Encalypta vulgaris",0,6,0,104,89,199,"LC"
"Didymodon rigidulus",0,37,1,48,112,198,"LC"
"Homalothecium philippeanum",0,8,0,104,84,196,"LC"
"Sciuro-hypnum plumosum",0,36,0,52,108,196,"LC"
"Sphagnum angustifolium",0,4,0,75,115,194,"LC-att"
"Pohlia cruda",0,18,0,19,156,193,"LC"
"Lophozia guttulata",0,42,0,16,133,191,"LC"
"Riccardia multifida",0,43,0,37,111,191,"LC-att"
"Riccia",0,0,0,106,85,191,""
"Nyholmiella obtusifolia",0,26,0,0,164,190,"LC"
"Fissidens bryoides",0,7,0,48,134,189,"LC"
"Preissia quadrata",0,7,0,32,146,185,"LC"
"Riccia sorocarpa",0,4,0,105,75,184,"LC"
"Oxyrrhynchium schleicheri",0,6,0,99,77,182,"LC"
"Pogonatum aloides",0,2,0,13,166,181,"LC"
"Hygroamblystegium humile",0,14,0,94,72,180,"LC-att"
"Racomitrium lanuginosum",0,8,0,92,80,180,"LC"
"Barbilophozia hatcheri",0,15,0,30,133,178,"LC"
"Leskea polycarpa",0,13,0,5,160,178,"LC"
"Frullania tamarisci",0,11,1,18,144,174,"NT"
"Hypnum jutlandicum",0,16,0,23,131,170,"LC"
"Racomitrium aciculare",0,13,0,19,138,170,"LC"
"Hygrohypnella ochracea",0,27,0,45,95,167,"LC"
"Pseudoleskeella catenulata",0,13,0,61,93,167,"LC"
"Racomitrium fasciculare",0,11,0,76,80,167,"LC"
"Diplophyllum taxifolium",0,18,0,10,138,166,"LC"
"Marsupella emarginata",0,23,0,19,124,166,"LC"
"Oligotrichum hercynicum",0,8,0,14,144,166,"LC"
"Campylopus introflexus",0,29,0,18,118,165,"LC"
"Palustriella decipiens",0,33,0,81,49,163,"LC-att"
"Ulota crispa",0,3,4,0,156,163,"LC"
"Sphagnum inundatum",0,2,1,107,51,161,"DD"
"Tortula subulata",0,11,0,33,117,161,"LC"
"Anomodon longifolius",0,16,0,2,142,160,"LC"
"Nardia geoscyphus",0,13,0,2,145,160,"LC"
"Pohlia",0,14,0,93,53,160,""
"Calypogeia fissa",0,22,0,15,119,156,"NT"
"Plagiothecium denticulatum var. denticulatum",0,0,0,0,156,156,"LC"
"Streblotrichum convolutum",0,16,0,63,76,155,"LC"
"Oxystegus tenuirostris",0,39,0,17,98,154,"LC-att"
"Scorpidium scorpioides",0,9,5,48,92,154,"EN"
"Physcomitrium pyriforme",0,5,0,97,50,152,"LC"
"Anthoceros agrestis",0,14,0,40,97,151,"LC"
"Philonotis caespitosa",0,24,0,65,61,150,"LC-att"
"Polytrichum perigoniale",0,16,0,89,44,149,"LC"
"Riccardia palmata",0,8,0,0,140,148,"LC-att"
"Dicranum flagellare",0,23,0,45,78,146,"LC-att"
"Brachythecium tommasinii",0,9,0,53,83,145,"LC"
"Hypnum cupressiforme var. lacunosum",0,5,0,84,56,145,"LC"
"Marsupella sphacelata",0,52,0,4,89,145,"LC"
"Didymodon fallax",0,40,0,14,88,142,"LC"
"Blindia acuta",0,34,0,52,55,141,"LC"
"Meesia triquetra",0,2,1,49,87,139,"CR"
"Racomitrium microcarpon",0,19,0,31,89,139,"LC"
"Sphagnum centrale",0,49,0,22,68,139,"LC-att"
"Fuscocephaloziopsis catenulata",0,26,1,0,111,138,"NT"
"Rhizomnium magnifolium",0,18,0,47,73,138,"LC-att"
"Taxiphyllum wissgrillii",0,18,0,11,108,137,"LC"
"Dicranoweisia cirrata",0,13,0,5,118,136,"LC"
"Metzgeria conjugata",0,6,0,29,101,136,"LC"
"Rhytidiadelphus",0,0,0,23,113,136,""
"Isopaches bicrenatus",0,6,0,5,124,135,"NT"
"Solenostoma sphaerocarpum",0,29,0,12,94,135,"LC"
"Neckera pennata",0,17,20,0,97,134,"VU"
"Sphagnum balticum",0,0,0,70,64,134,"LC-att"
"Weissia longifolia",0,17,0,66,51,134,"LC"
"Dicranella schreberiana",0,12,0,20,101,133,"LC"
"Ditrichum heteromallum",0,30,0,12,91,133,"LC"
"Trichodon cylindricus",0,26,0,10,97,133,"LC"
"Sphagnum obtusum",0,29,0,66,37,132,"NT"
"Bryum rubens",0,9,0,28,93,130,"LC"
"Grimmia ovalis",0,21,0,47,62,130,"LC"
"Lophoziopsis excisa",0,17,0,5,108,130,"LC-att"
"Mannia fragrans",0,10,0,44,75,129,"NT"
"Metzgeria pubescens",0,5,0,26,98,129,"LC-att"
"Mesoptychia bantriensis",0,32,0,8,88,128,"LC"
"Pseudoamblystegium subtile",0,29,10,7,82,128,"LC-att"
"Amphidium mougeotii",0,52,0,6,69,127,"LC"
"Dicranella staphylina",0,21,0,13,92,126,"LC"
"Dicranum undulatum",0,1,0,86,38,125,"LC-att"
"Trichocolea tomentella",0,12,0,22,90,124,"LC-att"
"Rhytidiadelphus subpinnatus",0,16,2,4,100,122,"LC-att"
"Drepanocladus",0,0,0,91,30,121,""
"Orthotrichum patens",0,12,31,0,78,121,"NT"
"Scapania uliginosa",0,15,0,44,62,121,"LC"
"Atrichum",0,0,0,7,113,120,""
"Gymnostomum aeruginosum",0,49,0,25,46,120,"LC"
"Liochlaena lanceolata",0,4,0,3,113,120,"NT"
"Plagiothecium denticulatum var. undulatum",0,11,0,10,98,119,"LC-att"
"Schistostega pennata",0,5,0,2,111,118,"LC"
"Hygroamblystegium varium",0,8,0,31,78,117,"LC"
"Tritomaria exsectiformis",0,8,0,7,101,116,"LC-att"
"Cephaloziella rubella",0,19,0,5,91,115,"LC"
"Cynodontium strumiferum",0,20,0,17,78,115,"LC"
"Fossombronia wondraczekii",0,10,0,9,96,115,"LC"
"Fuscocephaloziopsis leucantha",0,15,1,7,92,115,"NT"
"Cynodontium",0,6,0,93,15,114,""
"Gymnomitrion concinnatum",0,67,0,1,45,113,"LC-att"
"Odontoschisma denudatum",0,12,0,8,93,113,"LC-att"
"Racomitrium aquaticum",0,14,0,13,85,112,"LC"
"Porella arboris-vitae",0,1,1,1,108,111,"NT"
"Lescuraea incurvata",0,33,0,20,56,109,"LC"
"Lophoziopsis longidens",0,10,1,12,86,109,"NT"
"Dicranum fulvum",0,30,3,21,54,108,"LC-att"
"Didymodon glaucus",0,23,26,0,59,108,"VU"
"Harpanthus scutatus",0,12,14,0,82,108,"EN"
"Weissia controversa",0,9,0,41,58,108,"LC"
"Bryum weigelii",0,12,0,39,56,107,"LC-att"
"Campylopus flexuosus",0,17,0,11,79,107,"LC"
"Fissidens pusillus",0,14,0,3,90,107,"LC-att"
"Porella cordaeana",0,22,0,2,83,107,"NT"
"Lophocolea minor",0,9,0,20,77,106,"LC"
"Bazzania tricrenata",0,20,2,0,83,105,"NT"
"Physcomitrium",0,1,0,90,14,105,""
"Riccia huebeneriana",0,0,5,58,42,105,"EN"
"Sphagnum affine",0,31,2,46,26,105,"VU"
"Bryum boreale",0,58,0,2,43,103,"LC"
"Calypogeia sphagnicola",0,5,0,32,66,103,"NT"
"Weissia",0,8,0,72,23,103,""
"Hygrohypnum luridum",0,14,0,36,52,102,"LC"
"Trilophozia quinquedentata",0,11,0,11,79,101,"LC"
"Grimmia",0,0,0,75,25,100,""
"Grimmia muehlenbeckii",0,35,0,0,65,100,"LC"
"Orthotrichum",0,4,0,9,87,100,""
"Antitrichia curtipendula",0,29,5,2,63,99,"LC-att"
"Dicranum spurium",0,7,0,48,44,99,"LC-att"
"Ptilidium",0,0,0,10,89,99,""
"Bryum pallens",0,14,0,22,62,98,"LC"
"Dicranum flexicaule",0,49,0,12,37,98,"LC"
"Kiaeria blyttii",0,32,0,14,52,98,"LC"
"Mnium marginatum",0,8,0,26,64,98,"LC"
"Solenostoma obovatum",0,25,0,9,64,98,"LC"
"Anastrophyllum michauxii",0,4,6,0,87,97,"EN"
"Calliergonella lindbergii",0,5,0,28,64,97,"LC"
"Hylocomium",0,0,0,19,77,96,""
"Campylium protensum",0,30,0,11,54,95,"LC-att"
"Herzogiella striatella",0,55,0,4,36,95,"NT"
"Tortella squarrosa",0,3,0,63,29,95,"NT"
"Amblystegium",0,0,0,49,45,94,""
"Eurhynchiastrum pulchellum",0,9,0,38,47,94,"LC-att"
"Pedinophyllum interruptum",0,4,0,18,71,93,"LC-att"
"Solenostoma gracillimum",0,14,0,0,79,93,"LC"
"Riccia glauca",0,7,0,25,60,92,"LC"
"Syntrichia ruralis var. ruralis",0,0,0,0,92,92,"LC"
"Plagiothecium platyphyllum",0,9,0,26,54,89,"LC-att"
"Hymenoloma crispulum",0,15,0,11,62,88,"LC"
"Pleuridium subulatum",0,8,0,38,41,87,"LC"
"Schistidium dupretii",0,28,0,0,58,86,"LC"
"Fontinalis squamosa",0,2,0,13,70,85,"LC"
"Sphagnum platyphyllum",0,8,2,24,51,85,"CR"
"Physcomitrella patens",0,1,1,48,34,84,"LC-att"
"Tortula",0,0,0,75,9,84,""
"Solenostoma hyalinum",0,11,0,4,67,82,"NT"
"Bartramia ithyphylla",0,14,0,9,58,81,"LC-att"
"Hygroamblystegium tenax",0,5,0,18,58,81,"LC-att"
"Tritomaria exsecta",0,14,1,1,65,81,"LC"
"Hygroamblystegium fluviatile",0,5,0,3,72,80,"LC"
"Lewinskya striata",0,6,2,0,72,80,"LC-att"
"Philonotis calcarea",0,7,0,44,29,80,"LC-att"
"Riccia ciliifera",0,1,0,26,53,80,"NT"
"Distichium capillaceum",0,18,0,20,41,79,"LC"
"Fissidens",0,0,0,40,39,79,""
"Diphyscium foliosum",0,9,2,15,52,78,"LC-att"
"Elodium blandowii",0,13,6,12,47,78,"EN"
"Grimmia ramondii",0,44,0,0,34,78,"LC-att"
"Hylocomiastrum umbratum",0,11,0,7,60,78,"LC-att"
"Lophozia ascendens",0,10,6,0,62,78,"EN"
"Phaeoceros carolinianus",0,6,0,6,66,78,"LC"
"Pterygoneurum ovatum",0,18,0,22,38,78,"LC"
"Pulvigera lyellii",0,16,0,0,62,78,"LC-att"
"Tortella pseudofragilis",0,21,0,2,55,78,"LC"
"Alleniella besseri",0,7,0,5,65,77,"LC"
"Riccia ciliata",0,1,13,2,61,77,"NT"
"Abietinella abietina var. abietina",0,0,0,0,76,76,"LC"
"Racomitrium macounii subsp. alpinum",0,49,0,0,27,76,"LC"
"Scapania mucronata",0,4,0,0,72,76,"DD"
"Tortula lindbergii",0,9,0,17,50,76,"LC"
"Weissia brachycarpa",0,12,0,21,42,75,"LC"
"Brachydontium trichodes",0,22,0,0,52,74,"LC-att"
"Dicranella varia",0,10,0,12,52,74,"LC"
"Dicranodontium asperulum",0,11,0,1,61,73,"NT"
"Lophozia silvicola",0,30,0,0,43,73,"LC-att"
"Plasteurhynchium striatulum",0,4,0,8,61,73,"LC-att"
"Sarmentypnum sarmentosum",0,8,0,40,25,73,"NT"
"Oxymitra incrassata",0,4,2,9,57,72,"EN"
"Pohlia elongata var. elongata",0,0,0,0,72,72,"LC-att"
"Reboulia hemisphaerica",0,4,0,9,59,72,"NT"
"Coscinodon cribrosus",0,25,0,4,42,71,"LC"
"Physcomitrium sphaericum",0,4,4,58,5,71,"VU"
"Bryum klinggraeffii",0,5,0,8,57,70,"LC"
"Campylophyllopsis calcarea",0,18,0,9,43,70,"LC-att"
"Fontinalis",0,0,0,0,70,70,""
"Orthothecium intricatum",0,17,0,16,37,70,"LC"
"Weissia condensa",0,15,0,19,36,70,"LC"
"Tortula caucasica",0,11,0,24,34,69,"LC"
"Scapania paludicola",0,12,3,19,34,68,"VU"
"Schistidium",0,6,0,17,45,68,""
"Schistidium papillosum",0,38,0,0,30,68,"LC"
"Physcomitrium eurystomum",0,1,4,48,14,67,"VU"
"Syntrichia montana",0,6,0,29,32,67,"LC"
"Grimmia donniana",0,19,0,0,47,66,"LC"
"Schljakovia kunzeana",0,4,2,10,50,66,"EN"
"Syzygiella autumnalis",0,7,9,1,49,66,"VU"
"Atrichum tenellum",0,7,0,25,33,65,"NT"
"Kiaeria starkei",0,32,0,12,21,65,"LC"
"Mnium lycopodioides",0,34,9,0,22,65,"LC-att"
"Orthotrichum cupulatum",0,0,0,8,57,65,"NE"
"Syntrichia virescens",0,12,0,1,52,65,"LC"
"Bryum elegans",0,13,0,17,34,64,"NT"
"Drepanocladus polygamus",0,23,3,11,27,64,"VU"
"Harpanthus flotovianus",0,17,0,3,43,63,"VU"
"Palustriella falcata",0,12,0,19,32,63,"LC"
"Pseudephemerum nitidum",0,8,0,27,28,63,"LC"
"Dicranum majus",0,17,6,19,20,62,"VU"
"Splachnum ampullaceum",0,5,4,4,49,62,"NT"
"Cirriphyllum crassinervium",0,10,0,12,39,61,"LC"
"Racomitrium elongatum",0,11,0,7,43,61,"LC"
"Brachythecium geheebii",0,6,2,2,50,60,"EN"
"Campylophyllopsis sommerfeltii",0,0,0,3,57,60,"LC-att"
"Plagiopus oederianus",0,12,13,17,18,60,"VU"
"Serpoleskea confervoides",0,4,1,10,45,60,"LC-att"
"Lewinskya affinis",0,58,0,1,0,59,"NE"
"Orthotrichum urnigerum",0,15,14,0,30,59,"VU"
"Hypnum vaucheri",0,12,0,17,29,58,"LC-att"
"Scapania",0,5,0,15,38,58,""
"Bryum dichotomum",0,9,0,8,40,57,"LC"
"Didymodon ferrugineus",0,9,0,12,35,56,"LC"
"Oxyrrhynchium speciosum",0,5,0,19,32,56,"LC-att"
"Pseudobryum cinclidioides",0,3,5,13,35,56,"EN"
"Riccia papillosa",0,1,8,0,47,56,"CR"
"Didymodon insulanus",0,30,0,0,25,55,"LC"
"Andreaea rothii subsp. falcata",0,53,0,0,0,53,"LC-att"
"Brachythecium campestre",0,9,0,23,21,53,"LC-att"
"Grimmia elongata",0,38,0,0,15,53,"NT"
"Plagiochila",0,0,0,9,44,53,""
"Scapania aequiloba",0,7,0,5,41,53,"NT"
"Sphagnum lindbergii",0,7,0,33,13,53,"LC"
"Crossocalyx hellerianus",0,3,4,0,45,52,"EN"
"Jungermannia pumila",0,20,0,0,32,52,"NT"
"Kurzia sylvatica",0,5,0,1,46,52,"LC-att"
"Trichostomum crispulum",0,16,0,23,13,52,"LC-att"
"Calypogeia suecica",0,10,3,10,28,51,"NT"
"Cephaloziella hampeana",0,10,0,0,41,51,"LC-att"
"Grimmia funalis",0,32,0,2,17,51,"LC-att"
"Radula lindenbergiana",0,26,0,1,24,51,"VU"
"Syntrichia calcicola",0,11,0,2,38,51,"LC"
"Bryum muehlenbeckii",0,32,0,0,18,50,"NT"
"Dicranella subulata",0,18,10,8,14,50,"VU"
"Pohlia nutans subsp. schimperi",0,27,1,0,22,50,"NT"
"Bryum alpinum",0,21,0,3,25,49,"NT"
"Buxbaumia aphylla",0,6,4,2,37,49,"NT"
"Dicranum muehlenbeckii",0,2,2,0,45,49,"CR"
"Fissidens gracilifolius",0,5,0,3,41,49,"LC"
"Rhynchostegium confertum",0,20,9,5,15,49,"LC-att"
"Blasia pusilla",0,3,0,2,43,48,"LC"
"Bryum archangelicum",0,4,1,39,4,48,"EN"
"Bryum violaceum",0,4,0,3,41,48,"LC"
"Cephaloziella",0,0,0,40,8,48,""
"Eucladium verticillatum",0,8,0,17,23,48,"LC"
"Grimmia incurva",0,12,0,8,28,48,"LC"
"Cephaloziella spinigera",0,4,1,0,42,47,"VU"
"Geocalyx graveolens",0,6,8,2,31,47,"VU"
"Scapania aspera",0,2,2,13,30,47,"VU"
"Didymodon cordatus",0,31,8,0,7,46,"VU"
"Pohlia annotina",0,13,0,9,24,46,"LC"
"Riccia canaliculata",0,0,0,44,2,46,"DD-va"
"Ulota",0,1,0,0,45,46,""
"Fissidens osmundoides",0,18,0,8,19,45,"LC-att"
"Philonotis",0,1,0,14,30,45,""
"Scapania curta",0,10,0,0,35,45,"LC"
"Schistidium brunnescens",0,1,0,13,31,45,"LC"
"Bartramia halleriana",0,13,0,5,26,44,"NT"
"Philonotis capillaris",0,2,1,1,40,44,"EN"
"Riccardia chamedryfolia",0,14,9,7,14,44,"VU"
"Grimmia trichophylla",0,12,0,13,18,43,"LC-att"
"Odontoschisma fluitans",0,0,0,20,23,43,"EN"
"Anthoceros neesii",0,1,5,0,36,42,"EN"
"Kurzia pauciflora",0,6,4,4,28,42,"VU"
"Timmia bavarica",0,6,0,12,24,42,"EN"
"Dicranodontium",0,0,0,1,39,40,""
"Anacamptodon splachnoides",0,10,7,0,22,39,"EN"
"Anthelia julacea",0,28,0,1,10,39,"VU"
"Lophozia wenzelii",0,9,0,5,25,39,"CR"
"Mesoptychia heterocolpos",0,3,1,0,35,39,"CR"
"Rhynchostegiella tenella",0,7,2,3,27,39,"NT"
"Schistidium helveticum",0,8,0,0,31,39,"LC-att"
"Syntrichia papillosa",0,6,0,0,33,39,"LC"
"Blindiadelphus recurvatus",0,5,0,0,33,38,"LC"
"Dicranella rufescens",0,6,0,6,26,38,"LC"
"Grimmia elatior",0,1,1,0,36,38,"CR"
"Philonotis tomentella",0,8,0,3,27,38,"VU"
"Pohlia drummondii",0,12,0,2,24,38,"LC"
"Didymodon acutus",0,13,1,6,17,37,"LC-att"
"Ditrichum lineare",0,20,0,2,15,37,"LC-att"
"Endogemma caespiticia",0,7,2,0,28,37,"LC-att"
"Ephemerum minutissimum",0,8,0,0,29,37,"LC"
"Metzgeria violacea",0,4,13,0,20,37,"VU"
"Orthotrichum rogeri",0,9,7,0,21,37,"VU"
"Schistidium robustum",0,24,0,0,13,37,"LC"
"Marsupella funckii",0,16,0,1,19,36,"NT"
"Pyramidula tetragona",0,4,0,0,32,36,"CR"
"Rhynchostegium megapolitanum",0,9,10,3,14,36,"VU"
"Zygodon rupestris",0,5,12,0,19,36,"NT"
"Aneura maxima",0,15,10,0,10,35,"NT"
"Cephalozia bicuspidata subsp. lammersiana",0,0,0,35,0,35,"NE"
"Cololejeunea rossettiana",0,2,2,7,24,35,"VU"
"Notothylas orbicularis",0,0,4,0,31,35,"CR"
"Rhizomnium pseudopunctatum",0,2,3,16,14,35,"EN"
"Anomodon rugelii",0,7,4,0,23,34,"VU"
"Ditrichum pusillum",0,14,0,1,19,34,"LC-att"
"Entodon",0,0,0,2,32,34,""
"Marchantia polymorpha subsp. polymorpha",0,2,0,2,30,34,"LC"
"Pohlia proligera",0,10,0,0,24,34,"LC"
"Pseudocrossidium hornschuchianum",0,10,0,8,16,34,"LC"
"Pterygoneurum subsessile",0,10,2,9,13,34,"VU"
"Fissidens exilis",0,1,0,7,25,33,"LC"
"Grimmia orbicularis",0,6,0,1,26,33,"LC-att"
"Jungermannia",0,0,0,4,29,33,""
"Obtusifolium obtusum",0,3,4,3,23,33,"EN"
"Pleuridium acuminatum",0,13,0,7,13,33,"LC-att"
"Pohlia ludwigii",0,18,4,2,9,33,"VU"
"Bryum schleicheri",0,4,0,24,4,32,"CR"
"Grimmia montana",0,16,0,2,14,32,"LC-att"
"Seligeria donniana",0,8,0,2,22,32,"LC"
"Splachnum sphaericum",0,7,0,4,21,32,"NT"
"Tortula acaulon var. pilifera",0,4,0,15,13,32,"LC"
"Barbula",0,0,0,30,1,31,""
"Drepanocladus sendtneri",0,1,1,14,15,31,"CR"
"Fissidens dubius var. dubius",0,0,0,0,31,31,"LC"
"Grimmia anomala",0,20,0,0,11,31,"VU"
"Grimmia laevigata",0,5,0,1,25,31,"LC"
"Hypnum callichroum",0,18,0,4,9,31,"EN"
"Jungermannia atrovirens",0,12,3,0,16,31,"VU"
"Scapania praetervisa",0,19,0,0,12,31,"VU"
"Andreaea rothii",0,0,1,0,29,30,"NE"
"Fuscocephaloziopsis macrostachya",0,17,6,0,7,30,"VU"
"Mannia triandra",0,0,0,0,30,30,"CR"
"Rhodobryum ontariense",0,5,1,4,20,30,"LC-att"
"Schistidium rivulare",0,10,0,0,20,30,"LC-att"
"Warnstorfia pseudostraminea",0,14,6,0,10,30,"EN"
"Acaulon muticum",0,2,4,0,23,29,"LC-att"
"Callicladium haldanianum",0,3,12,1,13,29,"VU"
"Dicranum elongatum",0,3,2,4,20,29,"EN"
"Fuscocephaloziopsis pleniceps",0,3,0,4,22,29,"VU"
"Scapania paludosa",0,13,3,2,11,29,"VU"
"Schistidium confertum",0,18,0,1,10,29,"VU"
"Conocephalum salebrosum",0,11,0,0,17,28,"LC"
"Drepanocladus trifarius",0,0,0,25,3,28,"CR"
"Encalypta",0,1,0,23,4,28,""
"Hilpertia velenovskyi",0,1,2,0,25,28,"CR"
"Isothecium",0,0,0,2,26,28,""
"Aloina rigida",0,7,0,1,19,27,"LC"
"Calliergon",0,0,0,12,15,27,""
"Campylopus fragilis",0,2,0,4,21,27,"LC-att"
"Grimmia longirostris",0,8,0,2,17,27,"LC"
"Microbryum floerkeanum",0,1,16,0,10,27,"VU"
"Bryoerythrophyllum ferruginascens",0,18,0,0,8,26,"LC-att"
"Campylopus pyriformis",0,6,2,3,15,26,"LC-att"
"Cephalozia",0,0,0,20,6,26,""
"Dicranodontium uncinatum",0,11,0,2,13,26,"EN"
"Ephemerum recurvifolium",0,0,10,11,5,26,"VU"
"Fuscocephaloziopsis loitlesbergeri",0,4,2,5,15,26,"VU"
"Grimmia anodon",0,10,4,3,9,26,"EN"
"Heterocladium dimorphum",0,11,5,1,9,26,"NT"
"Moerckia flotoviana",0,10,0,0,16,26,"CR"
"Orthotrichum pulchellum",0,2,16,0,8,26,"LC-att"
"Scapania cuspiduligera",0,16,0,0,10,26,"VU"
"Scapania gymnostomophila",0,6,0,3,17,26,"EN"
"Scapania scandica",0,18,0,1,7,26,"DD"
"Scapania subalpina",0,7,0,2,17,26,"NT"
"Tetrodontium repandum",0,5,0,0,21,26,"NT"
"Bazzania",0,0,0,3,22,25,""
"Bryum pseudotriquetrum var. bimum",0,8,0,3,14,25,"LC-att"
"Hookeria lucens",0,3,8,1,13,25,"NT"
"Pohlia camptotrachela",0,7,0,2,16,25,"LC-att"
"Rhabdoweisia crispata",0,5,0,0,20,25,"NT"
"Tortula acaulon var. acaulon",0,0,0,0,25,25,"LC"
"Ulota hutchinsiae",0,0,0,0,25,25,"EN"
"Acaulon triquetrum",0,9,6,0,9,24,"VU"
"Campylostelium saxicola",0,8,1,0,15,24,"NT"
"Pseudoleskeella rupestris",0,18,0,0,6,24,"VU"
"Tayloria tenuis",0,5,1,1,17,24,"EN"
"Bryum pseudotriquetrum var. pseudotriquetrum",0,0,0,0,23,23,"LC"
"Cololejeunea calcarea",0,5,3,0,15,23,"VU"
"Cratoneuron",0,0,0,11,12,23,""
"Cynodontium bruntonii",0,7,0,4,12,23,"LC-att"
"Fissidens viridulus var. viridulus",0,0,0,0,23,23,"LC"
"Gymnomitrion corallioides",0,4,0,0,19,23,"CR"
"Orthotrichum scanicum",0,3,1,0,19,23,"CR"
"Amphidium lapponicum",0,14,0,0,8,22,"EN"
"Asterella saccata",0,3,0,1,18,22,"EN"
"Encalypta ciliata",0,8,0,0,14,22,"VU"
"Entodon schleicheri",0,0,1,0,21,22,"DD"
"Grimmia crinita",0,9,2,0,11,22,"EN"
"Grimmia tergestina",0,6,0,3,13,22,"LC-att"
"Hylocomiastrum pyrenaicum",0,7,0,0,15,22,"VU"
"Myurella julacea",0,12,0,1,9,22,"EN"
"Riccardia incurvata",0,7,0,2,13,22,"VU"
"Weissia fallax",0,9,0,0,13,22,"LC-att"
"Weissia wimmeriana",0,11,0,0,11,22,"VU"
"Zygodon dentatus",0,8,6,0,8,22,"NT"
"Atrichum angustatum",0,1,3,10,7,21,"EN"
"Bryum cyclophyllum",0,1,2,0,18,21,"EN"
"Bryum subapiculatum",0,10,0,0,11,21,"LC"
"Didymodon spadiceus",0,11,1,0,9,21,"NT"
"Ephemerum serratum",0,1,0,1,19,21,"DD"
"Grimmia sessitana",0,14,0,0,7,21,"VU"
"Lewinskya rupestris",0,6,4,0,11,21,"VU"
"Pohlia erecta",0,0,0,0,21,21,"NE"
"Riccia warnstorfii",0,0,5,0,16,21,"VU"
"Didymodon sinuosus",0,5,3,0,12,20,"VU"
"Fissidens gymnandrus",0,9,0,0,11,20,"LC"
"Flexitrichum gracile",0,11,0,0,9,20,"LC-att"
"Fossombronia foveolata",0,4,0,0,16,20,"EN"
"Grimmia alpestris",0,11,0,3,6,20,"VU"
"Hymenostylium recurvirostrum",0,9,0,4,7,20,"VU"
"Moerckia blyttii",0,2,0,2,16,20,"EN"
"Plagiothecium latebricola",0,1,3,6,10,20,"VU"
"Racomitrium affine",0,8,1,1,10,20,"LC-att"
"Bazzania flaccida",0,1,4,0,14,19,"VU"
"Conardia compacta",0,3,4,0,12,19,"EN"
"Heterogemma capitata",0,8,2,1,8,19,"VU"
"Mannia gracilis",0,3,1,0,15,19,"EN"
"Odontoschisma sphagni",0,6,2,0,11,19,"EN"
"Paraleucobryum",0,0,0,1,18,19,""
"Paraleucobryum sauteri",0,0,0,19,0,19,"RE"
"Plagiobryum zieri",0,11,0,0,8,19,"EN"
"Pogonatum nanum",0,2,6,1,10,19,"VU"
"Pottiopsis caespitosa",0,4,0,0,15,19,"CR"
"Scapania calcicola",0,0,1,2,16,19,"EN"
"Schistidium pruinosum",0,11,1,0,7,19,"LC-att"
"Solenostoma confertissimum",0,9,0,0,10,19,"VU"
"Syntrichia ruralis var. ruraliformis",0,3,0,10,6,19,"LC-att"
"Targionia hypophylla",0,0,0,0,19,19,"CR"
"Entodon concinnus",0,3,0,2,13,18,"LC-att"
"Entosthodon fascicularis",0,2,1,6,9,18,"VU"
"Gymnomitrion alpinum",0,14,0,0,4,18,"EN"
"Lunularia cruciata",0,0,0,0,18,18,"LC"
"Neckera",0,0,0,0,18,18,""
"Orthotrichum cupulatum var. cupulatum",0,8,0,0,10,18,"LC"
"Riccia bifurca",0,0,2,0,16,18,"LC-att"
"Schistidium trichodon",0,6,0,1,11,18,"NE"
"Sphenolobus saxicola",0,2,0,0,16,18,"VU"
"Barbilophozia",0,0,0,17,0,17,""
"Grimmia torquata",0,11,0,0,6,17,"VU"
"Microbryum curvicollum",0,6,0,0,11,17,"LC-att"
"Plagiothecium denticulatum var. obtusifolium",0,17,0,0,0,17,"VU"
"Platyhypnum molle",0,0,0,0,17,17,"DD"
"Pohlia bulbifera",0,4,0,2,11,17,"LC"
"Tortula protobryoides",0,6,0,3,8,17,"LC-att"
"Weissia rutilans",0,2,1,14,0,17,"EN"
"Campylophyllum halleri",0,7,0,2,7,16,"EN"
"Distichium",0,0,0,14,2,16,""
"Lophocolea",0,0,0,16,0,16,""
"Marsupella sprucei",0,6,1,0,9,16,"EN"
"Platyhypnum duriusculum",0,14,1,0,1,16,"NT"
"Pohlia andalusica",0,5,1,1,9,16,"LC-att"
"Pohlia elongata",0,15,0,1,0,16,"NE"
"Pterygoneurum lamellatum",0,6,3,0,7,16,"EN"
"Riccia gougetiana",0,3,0,0,13,16,"NE"
"Scapania compacta",0,0,0,13,3,16,"DD-va"
"Seligeria pusilla",0,3,0,0,13,16,"VU"
"Tetrodontium brownianum",0,3,7,0,6,16,"NT"
"Cynodontium gracilescens",0,9,0,0,6,15,"VU"
"Hypnum cupressiforme var. filiforme",0,0,0,0,15,15,"LC"
"Hypnum cupressiforme var. subjulaceum",0,14,0,0,1,15,"NT"
"Campyliadelphus elodes",0,1,0,7,6,14,"DD-va"
"Didymodon",0,0,0,11,3,14,""
"Didymodon luridus",0,5,0,0,9,14,"NT"
"Fissidens dubius var. mucronatus",0,1,0,0,13,14,"LC"
"Fissidens fontanus",0,0,5,1,8,14,"NT"
"Gyroweisia tenuis",0,1,4,0,9,14,"DD"
"Isopterygiopsis muelleriana",0,1,1,4,8,14,"CR"
"Marchantia polymorpha subsp. ruderalis",0,3,0,0,11,14,"LC"
"Marsupella aquatica",0,8,0,5,1,14,"LC"
"Pohlia lescuriana",0,7,4,1,2,14,"LC-att"
"Schistidium lancifolium",0,4,0,0,10,14,"LC-att"
"Schljakovianthus quadrilobus",0,6,0,1,7,14,"EN"
"Sciuro-hypnum flotowianum",0,1,0,4,9,14,"DD"
"Tetralophozia setiformis",0,4,0,0,10,14,"VU"
"Bryum turbinatum",0,1,0,10,2,13,"EN"
"Campylium",0,0,0,10,3,13,""
"Hypnum fertile",0,3,2,0,8,13,"CR"
"Isopterygiopsis pulchella",0,3,1,0,9,13,"CR"
"Lescuraea patens",0,6,0,2,5,13,"EN"
"Loeskeobryum brevirostre",0,2,2,4,5,13,"NT"
"Marchantia polymorpha subsp. montivagans",0,13,0,0,0,13,"LC-att"
"Pohlia wahlenbergii var. glacialis",0,13,0,0,0,13,"NE"
"Rhizomnium",0,0,0,4,9,13,""
"Tayloria serrata",0,1,2,6,4,13,"EN"
"Weissia squarrosa",0,1,7,0,5,13,"VU"
"Aloina aloides var. ambigua",0,6,6,0,0,12,"EN"
"Aloina obliquifolia",0,7,0,0,5,12,"LC"
"Cleistocarpidium palustre",0,6,2,1,3,12,"VU"
"Cynodontium tenellum",0,4,1,0,7,12,"VU"
"Discelium nudum",0,1,6,0,5,12,"VU"
"Distichium inclinatum",0,7,0,1,4,12,"EN"
"Ditrichum zonatum",0,7,0,0,5,12,"EN"
"Pseudocrossidium revolutum",0,3,3,1,5,12,"EN"
"Streblotrichum commutatum",0,2,3,0,7,12,"DD"
"Tetraplodon angustatus",0,6,2,1,3,12,"VU"
"Tortula inermis",0,4,4,0,4,12,"CR"
"Brachythecium erythrorrhizon",0,0,0,1,10,11,"NE"
"Brachythecium tenuicaule",0,4,3,0,4,11,"CR"
"Bryum radiculosum",0,0,0,0,11,11,"LC-att"
"Chiloscyphus",0,0,0,10,1,11,""
"Hygrobiella laxifolia",0,4,1,0,6,11,"VU"
"Marsupella sparsifolia",0,3,0,0,8,11,"CR"
"Pohlia melanodon",0,1,4,1,5,11,"VU"
"Scapania helvetica",0,1,0,1,9,11,"CR"
"Anoectangium aestivum",0,6,0,0,4,10,"EN"
"Bryum gemmiferum",0,2,2,0,6,10,"LC-att"
"Cephaloziella elegans",0,0,1,0,9,10,"CR"
"Didymodon validus",0,6,4,0,0,10,"EN"
"Fissidens viridulus var. incurvus",0,1,0,0,9,10,"LC-att"
"Homalothecium",0,0,0,5,5,10,""
"Lescuraea mutabilis",0,3,0,0,7,10,"EN"
"Lewinskya affinis var. bohemica",6,1,1,0,2,10,"DD"
"Mnium thomsonii",0,5,0,1,4,10,"CR"
"Plagiothecium neckeroideum",0,1,0,2,7,10,"EN"
"Pleuridium",0,0,0,8,2,10,""
"Pseudoleskeella tectorum",0,1,0,0,9,10,"CR"
"Schistidium brunnescens subsp. brunnescens",0,10,0,0,0,10,"LC"
"Schistidium elegantulum",0,0,0,0,10,10,"LC-att"
"Tortula muralis subsp. muralis var. muralis",0,10,0,0,0,10,"LC"
"Bryum creberrimum",0,7,0,0,2,9,"EN"
"Chiloscyphus polyanthos var. polyanthos",0,0,0,9,0,9,"NE"
"Didymodon vinealis",0,1,0,6,2,9,"EN"
"Fissidens arnoldii",0,0,7,0,2,9,"EN"
"Mesoptychia badensis",0,4,2,0,3,9,"VU"
"Saelania glaucescens",0,3,0,0,6,9,"EN"
"Schistidium confusum",0,6,0,0,3,9,"LC-att"
"Schistidium flaccidum",0,0,0,0,9,9,"EN"
"Syntrichia latifolia",0,3,1,1,4,9,"NT"
"Andreaea rothii subsp. rothii",0,8,0,0,0,8,"EN"
"Bryum uliginosum",0,4,3,1,0,8,"EN"
"Cephaloziella grimsulana",0,4,0,0,4,8,"EN"
"Ceratodon",0,0,0,0,8,8,""
"Encalypta rhaptocarpa",0,8,0,0,0,8,"NE"
"Entosthodon muhlenbergii",0,0,1,0,7,8,"CR"
"Frullania inflata",0,3,2,0,3,8,"EN"
"Grimmia atrata",0,6,0,0,2,8,"VU"
"Haplomitrium hookeri",0,4,0,0,4,8,"CR"
"Kurzia",0,0,0,8,0,8,""
"Lescuraea plicata",0,3,0,3,2,8,"EN"
"Riccardia",0,0,0,2,6,8,""
"Schistidium trichodon var. nutans",0,8,0,0,0,8,"LC-att"
"Schistochilopsis grandiretis",0,1,1,0,6,8,"VU"
"Seligeria calcarea",0,4,2,0,2,8,"EN"
"Thamnobryum neckeroides",0,2,0,0,6,8,"EN"
"Ulota crispula",0,6,0,0,2,8,"NE"
"Andreaea frigida",0,5,0,0,2,7,"CR"
"Anomobryum concinnatum",0,4,0,0,3,7,"CR"
"Brachydontium",0,0,0,7,0,7,""
"Bryum funkii",0,1,0,4,2,7,"DD"
"Bryum intermedium",0,2,1,3,1,7,"CR"
"Cephaloziella elachista",0,3,0,0,4,7,"EN"
"Dicranum spadiceum",0,1,0,0,6,7,"CR"
"Didymodon tophaceus",0,4,0,0,3,7,"LC-att"
"Ditrichum pallidum",0,0,1,1,5,7,"VU"
"Entosthodon pulchellus",0,2,0,0,5,7,"EN"
"Ephemerum",0,0,0,1,6,7,""
"Fontinalis hypnoides",0,1,1,4,1,7,"EN"
"Lescuraea radicosa",0,6,0,0,1,7,"EN"
"Metzgeria simplex",0,0,0,0,7,7,"NE"
"Nardia compressa",0,4,0,0,3,7,"VU"
"Rhynchostegiella teneriffae",0,1,4,0,2,7,"EN"
"Seligeria",0,4,0,2,1,7,""
"Seligeria acutifolia",0,1,2,0,4,7,"VU"
"Syntrichia",0,1,0,0,6,7,""
"Tortella",0,1,0,4,2,7,""
"Tortula atrovirens",0,4,3,0,0,7,"CR"
"Ulota intermedia",0,7,0,0,0,7,"NE"
"Andreaea crassinervia",0,2,1,0,3,6,"CR"
"Blindiadelphus campylopodus",0,0,3,0,3,6,"VU"
"Bryum mildeanum",0,2,1,1,2,6,"VU"
"Bryum tenuisetum",0,4,0,0,2,6,"DD"
"Crossidium squamiferum",0,1,0,2,3,6,"CR"
"Fossombronia",0,1,0,2,3,6,""
"Grimmia dissimulata",0,4,2,0,0,6,"DD"
"Grimmia teretinervis",0,1,0,0,5,6,"CR"
"Hennediella heimii",0,3,2,0,1,6,"DD-va"
"Mesoptychia collaris",0,0,0,6,0,6,"NE"
"Microbryum davallianum",0,0,1,3,2,6,"NE"
"Mielichhoferia mielichhoferiana",0,0,0,0,6,6,"CR"
"Moerckia hibernica",0,0,0,1,5,6,"NE"
"Odontoschisma francisci",0,0,0,0,6,6,"CR"
"Orthotrichum stellatum",0,2,1,0,3,6,"CR"
"Philonotis marchica",0,0,2,2,2,6,"CR"
"Racomitrium macounii subsp. macounii",0,4,0,0,2,6,"EN"
"Radula",0,0,0,0,6,6,""
"Rhabdoweisia crenulata",0,1,0,0,5,6,"EN"
"Sphagnum molle",0,0,0,0,6,6,"RE"
"Tetraplodon mnioides",0,3,1,0,2,6,"VU"
"Tortula hoppeana",0,2,0,0,4,6,"EN"
"Tortula mucronifolia",0,1,0,2,3,6,"CR"
"Tortula muralis subsp. muralis var. aestiva",0,6,0,0,0,6,"LC"
"Bryum algovicum",0,0,0,2,3,5,"DD-va"
"Bryum ruderale",0,1,0,2,2,5,"DD"
"Campylopus subulatus",0,2,2,0,1,5,"VU"
"Gymnostomum viridulum",0,4,1,0,0,5,"VU"
"Hypnum cupressiforme var. resupinatum",0,0,0,0,5,5,"NE"
"Isopterygiopsis",0,0,0,5,0,5,""
"Marchantia",0,0,0,5,0,5,""
"Neckera menziesii",0,0,1,0,4,5,"CR"
"Oxyrrhynchium hians var. rigidum",0,4,0,1,0,5,"NE"
"Palustriella",0,0,0,0,5,5,""
"Rhynchostegium rotundifolium",0,1,0,0,4,5,"EN"
"Scapania lingulata",0,1,0,0,4,5,"EN"
"Schistochilopsis opacifolia",0,5,0,0,0,5,"DD-va"
"Syntrichia fragilis",0,3,0,0,2,5,"CR"
"Trichostomum brachydontium",0,0,0,5,0,5,"DD-va"
"Campylopus",0,0,0,3,1,4,""
"Dicranella crispa",0,0,0,4,0,4,"DD-va"
"Ditrichum",0,1,0,3,0,4,""
"Encalypta rhaptocarpa var. rhaptocarpa",0,0,0,0,4,4,"EN"
"Fissidens viridulus",0,3,0,1,0,4,"NE"
"Hypnum imponens",0,2,1,0,1,4,"CR"
"Kiaeria falcata",0,2,0,0,2,4,"EN"
"Kurzia trichoclados",0,0,0,0,4,4,"EN"
"Meesia longiseta",0,0,0,0,4,4,"RE"
"Orthocaulis atlanticus",0,1,0,0,3,4,"RE"
"Plagiochila spinulosa",0,0,0,0,4,4,"NE"
"Pohlia filum",0,0,0,2,2,4,"VU"
"Riccia crinita",0,3,0,1,0,4,"NE"
"Scapania parvifolia",0,2,0,0,2,4,"CR"
"Schistidium elegantulum subsp. elegantulum",0,4,0,0,0,4,"LC-att"
"Sphagnum pulchrum",0,0,0,2,2,4,"NE"
"Splachnum",0,0,0,0,4,4,""
"Syntrichia norvegica",0,0,0,0,4,4,"CR"
"Tortella fragilis",0,0,0,4,0,4,"NE"
"Tortula lingulata",0,0,0,0,4,4,"CR"
"Zygodon viridissimus",0,1,2,0,1,4,"EN"
"Aloina brevirostris",0,0,0,0,3,3,"CR"
"Amblyodon dealbatus",0,0,0,0,3,3,"CR"
"Anthelia juratzkana",0,1,0,0,2,3,"CR"
"Bryum longisetum",0,0,0,0,3,3,"RE"
"Calliergonella",0,0,0,3,0,3,""
"Ceratodon conicus",0,2,0,0,1,3,"NE"
"Climacium",0,0,0,3,0,3,""
"Dicranella humilis",0,1,1,0,1,3,"VU"
"Didymodon umbrosus",0,3,0,0,0,3,"NE"
"Fissidens bambergeri",0,1,0,0,2,3,"EN"
"Fossombronia pusilla",0,0,2,0,1,3,"DD-va"
"Hedwigia",0,0,0,0,3,3,""
"Hedwigia ciliata var. leucophaea",0,3,0,0,0,3,"NE"
"Hydrogonium croceum",0,1,1,0,1,3,"CR"
"Lepidozia",0,0,0,1,2,3,""
"Leptodictyum",0,0,0,3,0,3,""
"Leskea",0,0,0,3,0,3,""
"Meesia uliginosa",0,1,0,1,1,3,"CR"
"Microeurhynchium pumilum",0,0,0,0,3,3,"DD"
"Microlejeunea ulicina",0,1,0,0,2,3,"CR"
"Pohlia longicolla",0,0,0,0,3,3,"EN"
"Pohlia tundrae",0,0,0,0,3,3,"CR"
"Polytrichastrum",0,0,0,0,3,3,""
"Porella",0,0,0,1,2,3,""
"Porella baueri",0,0,0,0,3,3,"NE"
"Pterygoneurum kozlovii",0,2,1,0,0,3,"NE"
"Taxiphyllum densifolium",0,0,0,2,1,3,"NE"
"Tayloria",0,1,0,0,2,3,""
"Tetrodontium ovatum",0,0,2,0,1,3,"DD"
"Timmia austriaca",0,1,1,0,1,3,"RE"
"Ulota coarctata",0,1,2,0,0,3,"CR"
"Warnstorfia",0,0,0,0,3,3,""
"Andreaea",0,0,0,0,2,2,""
"Anomodon",0,0,0,1,1,2,""
"Anthoceros",0,0,0,1,1,2,""
"Archidium alternifolium",0,1,0,0,1,2,"CR"
"Arctoa fulvella",0,0,0,0,2,2,"RE"
"Aulacomnium",0,0,0,2,0,2,""
"Brachythecium capillaceum",0,1,1,0,0,2,"DD-va"
"Cirriphyllum",0,0,0,2,0,2,""
"Conocephalum",0,0,0,0,2,2,""
"Didymodon sicculus",0,1,1,0,0,2,"NE"
"Drepanocladus lycopodioides",0,0,0,2,0,2,"RE"
"Frullania fragilifolia",0,0,0,0,2,2,"CR"
"Funaria",0,0,0,1,1,2,""
"Grimmia caespiticia",0,2,0,0,0,2,"DD"
"Hygrohypnum",0,0,0,2,0,2,""
"Leptobryum",0,0,0,2,0,2,""
"Leptoscyphus",0,0,0,2,0,2,""
"Marsupella",0,0,0,2,0,2,""
"Nardia insecta",0,0,0,0,2,2,"DD-va"
"Orthothecium rufescens",0,0,0,2,0,2,"RE"
"Orthotrichum schimperi",0,2,0,0,0,2,"NE"
"Oxyrrhynchium hians var. hians",0,0,0,2,0,2,"NE"
"Plagiobryum demissum",0,0,0,0,2,2,"NE"
"Platydictya jungermannioides",0,1,0,0,1,2,"CR"
"Pohlia lutescens",0,1,0,0,1,2,"DD"
"Pohlia sphagnicola",0,0,0,2,0,2,"NE"
"Rhodobryum",0,0,0,0,2,2,""
"Rhynchostegium",0,0,0,2,0,2,""
"Rhytidium",0,0,0,2,0,2,""
"Ricciocarpos",0,0,0,2,0,2,""
"Scapania apiculata",0,1,0,0,1,2,"CR"
"Scleropodium",0,0,0,1,1,2,""
"Tortula muralis subsp. obtusifolia",0,0,0,0,2,2,"NE"
"Tortula schimperi",0,2,0,0,0,2,"DD"
"Abietinella abietina var. hystricosa",0,0,0,1,0,1,"DD"
"Aneura",0,0,0,1,0,1,""
"Anomodon rostratus",0,0,0,0,1,1,"DD-va"
"Bartramia",0,0,0,0,1,1,""
"Bazzania trilobata var. depauperata",0,1,0,0,0,1,"NE"
"Biantheridion undulifolium",0,0,0,0,1,1,"RE"
"Brachythecium laetum",0,0,0,1,0,1,"EN"
"Bryum knowltonii",0,0,0,1,0,1,"NE"
"Bryum kunzei",0,0,0,0,1,1,"DD"
"Cephalozia lacinulata",0,0,0,0,1,1,"RE"
"Cephaloziella stellulifera",0,0,0,0,1,1,"CR"
"Cinclidotus fontinaloides",0,0,1,0,0,1,"CR"
"Cinclidotus riparius",0,1,0,0,0,1,"VU"
"Cynodontium fallax",0,0,0,0,1,1,"NE"
"Dichelyma",0,0,0,1,0,1,""
"Dichodontium",0,0,0,0,1,1,""
"Dicranoweisia",0,0,0,0,1,1,""
"Drepanocladus longifolius",0,0,0,0,1,1,"DD-va"
"Encalypta rhaptocarpa var. leptodon",0,0,0,0,1,1,"DD"
"Eurhynchiastrum pulchellum var. pulchellum",0,0,0,1,0,1,"NE"
"Fissidens limbatus",0,0,0,0,1,1,"DD"
"Fissidens rivularis",0,0,0,0,1,1,"NE"
"Fissidens rufulus",0,0,0,0,1,1,"NT"
"Fossombronia angulosa",0,0,0,0,1,1,"RE"
"Gymnomitrion brevissimum",0,0,0,0,1,1,"RE"
"Gymnomitrion obtusum",0,0,0,0,1,1,"RE"
"Gymnostomum",0,1,0,0,0,1,""
"Gymnostomum calcareum",0,0,1,0,0,1,"DD"
"Herzogiella",0,0,0,0,1,1,""
"Hygroamblystegium",0,0,0,0,1,1,""
"Hypnum cupressiforme var. heseleri",0,1,0,0,0,1,"DD"
"Hypnum recurvatum",0,0,0,0,1,1,"CR"
"Hypnum sauteri",0,0,0,0,1,1,"CR"
"Lescuraea saxicola",0,0,0,1,0,1,"DD-va"
"Liochlaena subulata",0,0,0,0,1,1,"CR"
"Mannia",0,1,0,0,0,1,""
"Meesia",0,0,0,1,0,1,""
"Mesoptychia",0,0,0,1,0,1,""
"Metzgeria",0,0,0,1,0,1,""
"Microbryum",0,0,0,0,1,1,""
"Mylia",0,0,0,1,0,1,""
"Nardia",0,0,0,0,1,1,""
"Neckera pumila",0,0,0,0,1,1,"RE"
"Odontoschisma",0,0,0,1,0,1,""
"Oncophorus wahlenbergii",0,0,0,0,1,1,"RE"
"Orthothecium",0,0,0,1,0,1,""
"Orthotrichum alpestre",1,0,0,0,0,1,"CR"
"Oxystegus",0,0,0,1,0,1,""
"Pallavicinia lyellii",0,0,0,0,1,1,"RE"
"Plagiopus",0,0,0,0,1,1,""
"Pogonatum",0,0,0,1,0,1,""
"Pohlia andrewsii",0,1,0,0,0,1,"NE"
"Pohlia elongata var. greenii",0,1,0,0,0,1,"NE"
"Pohlia wahlenbergii var. calcarea",0,1,0,0,0,1,"NE"
"Polytrichastrum sexangulare",0,0,0,1,0,1,"RE"
"Pterygoneurum",0,0,0,1,0,1,""
"Racomitrium ericoides",0,1,0,0,0,1,"NE"
"Scapania carinthiaca var. massalongi",0,0,0,0,1,1,"RE"
"Schistidium strictum",0,0,0,0,1,1,"NE"
"Schistidium trichodon var. trichodon",0,0,0,0,1,1,"LC-att"
"Syntrichia laevipila",0,0,0,0,1,1,"DD-va"
"Syntrichia montana var. calva",0,1,0,0,0,1,"NE"
"Tayloria splachnoides",0,0,0,1,0,1,"RE"
"Thamnobryum",0,0,0,0,1,1,""
"Trematodon ambiguus",0,0,0,0,1,1,"CR"
"Trichostomum",0,0,0,1,0,1,""
"Weissia levieri",0,0,0,1,0,1,"NE"
"Weissia rostellata",0,0,0,1,0,1,"DD-va"
