"spec","Osobní nálezy","ČBFS","Bryonora (M)","ČNFD","NDOP","total","RL_eval"
"Racomitrium sudeticum",0,159,159,159,159,636,"LC"
"Hamatocaulis vernicosus",0,132,132,132,132,528,"VU"
"Cephalozia bicuspidata",0,112,112,112,112,448,"LC"
"Barbilophozia sudetica",0,109,109,109,109,436,"LC"
"Sphagnum palustre",0,96,96,96,96,384,"LC"
"Cephaloziella divaricata",0,88,88,88,88,352,"LC"
"Dicranum scoparium",0,80,80,80,80,320,"LC"
"Campylium stellatum",0,77,77,77,77,308,"NT"
"Gymnomitrion concinnatum",0,67,67,67,67,268,"LC-att"
"Orthotrichum stramineum",0,66,66,66,66,264,"LC"
"Sphagnum papillosum",0,66,66,66,66,264,"LC"
"Scapania irrigua",0,65,65,65,65,260,"LC"
"Scorpidium cossonii",0,65,65,65,65,260,"NT"
"Sphagnum contortum",0,63,63,63,63,252,"NT"
"Bryum boreale",0,58,58,58,58,232,"LC"
"Lewinskya affinis",0,58,58,58,58,232,"NE"
"Andreaea rupestris",0,55,55,55,55,220,"LC"
"Herzogiella striatella",0,55,55,55,55,220,"NT"
"Andreaea rothii subsp. falcata",0,53,53,53,53,212,"LC-att"
"Calliergonella cuspidata",0,53,53,53,53,212,"LC"
"Pohlia nutans",0,53,53,53,53,212,"NE"
"Schistidium apocarpum",0,53,53,53,53,212,"LC"
"Amphidium mougeotii",0,52,52,52,52,208,"LC"
"Cynodontium polycarpon",0,52,52,52,52,208,"LC"
"Marsupella sphacelata",0,52,52,52,52,208,"LC"
"Orthotrichum pallens",3,51,51,51,51,207,"LC"
"Sphagnum subsecundum",0,51,51,51,51,204,"LC"
"Lewinskya affinis var. affinis",202,0,0,0,0,202,"LC"
"Dicranum flexicaule",0,49,49,49,49,196,"LC"
"Grimmia hartmanii",0,49,49,49,49,196,"LC"
"Gymnostomum aeruginosum",0,49,49,49,49,196,"LC"
"Racomitrium macounii subsp. alpinum",0,49,49,49,49,196,"LC"
"Sphagnum centrale",0,49,49,49,49,196,"LC-att"
"Sphagnum warnstorfii",0,48,48,48,48,192,"LC-att"
"Schistidium crassipilum",0,46,46,46,46,184,"LC"
"Orthotrichum diaphanum",108,18,18,18,18,180,"LC"
"Sarmentypnum exannulatum",0,45,45,45,45,180,"LC"
"Brachythecium rivulare",0,44,44,44,44,176,"LC"
"Bryoerythrophyllum recurvirostrum",0,44,44,44,44,176,"LC"
"Grimmia ramondii",0,44,44,44,44,176,"LC-att"
"Lewinskya speciosa",0,44,44,44,44,176,"LC"
"Orthotrichum pumilum",0,44,44,44,44,176,"LC"
"Bryum pseudotriquetrum",0,43,43,43,43,172,"NE"
"Calliergon giganteum",0,43,43,43,43,172,"VU"
"Riccardia multifida",0,43,43,43,43,172,"LC-att"
"Dicranum viride",0,42,42,42,42,168,"NT"
"Lophozia guttulata",0,42,42,42,42,168,"LC"
"Amblystegium serpens",0,41,41,41,41,164,"LC"
"Didymodon fallax",0,40,40,40,40,160,"LC"
"Pseudocampylium radicale",0,40,40,40,40,160,"LC-att"
"Oxystegus tenuirostris",0,39,39,39,39,156,"LC-att"
"Grimmia elongata",0,38,38,38,38,152,"NT"
"Nardia scalaris",0,38,38,38,38,152,"LC"
"Schistidium papillosum",0,38,38,38,38,152,"LC"
"Blepharostoma trichophyllum",0,37,37,37,37,148,"LC"
"Didymodon rigidulus",0,37,37,37,37,148,"LC"
"Gymnocolea inflata",0,37,37,37,37,148,"LC"
"Dicranum montanum",0,36,36,36,36,144,"LC"
"Philonotis fontana",0,36,36,36,36,144,"LC"
"Rhabdoweisia fugax",0,36,36,36,36,144,"LC"
"Sanionia uncinata",0,36,36,36,36,144,"LC"
"Sciuro-hypnum plumosum",0,36,36,36,36,144,"LC"
"Sphagnum subnitens",0,36,36,36,36,144,"LC-att"
"Ceratodon purpureus",0,35,35,35,35,140,"LC"
"Grimmia muehlenbeckii",0,35,35,35,35,140,"LC"
"Plagiochila porelloides",0,35,35,35,35,140,"LC"
"Polytrichum formosum",0,35,35,35,35,140,"LC"
"Sphagnum flexuosum",0,35,35,35,35,140,"LC"
"Blindia acuta",0,34,34,34,34,136,"LC"
"Mnium lycopodioides",0,34,34,34,34,136,"LC-att"
"Aneura pinguis",0,33,33,33,33,132,"LC"
"Fissidens adianthoides",0,33,33,33,33,132,"LC-att"
"Lescuraea incurvata",0,33,33,33,33,132,"LC"
"Palustriella decipiens",0,33,33,33,33,132,"LC-att"
"Sciuro-hypnum starckii",0,33,33,33,33,132,"LC"
"Tortella tortuosa",0,33,33,33,33,132,"LC"
"Bryum muehlenbeckii",0,32,32,32,32,128,"NT"
"Dicranella heteromalla",0,32,32,32,32,128,"LC"
"Grimmia funalis",0,32,32,32,32,128,"LC-att"
"Kiaeria blyttii",0,32,32,32,32,128,"LC"
"Kiaeria starkei",0,32,32,32,32,128,"LC"
"Mesoptychia bantriensis",0,32,32,32,32,128,"LC"
"Dicranodontium denudatum",0,31,31,31,31,124,"LC"
"Didymodon cordatus",0,31,31,31,31,124,"VU"
"Hypnum andoi",0,31,31,31,31,124,"LC"
"Sphagnum affine",0,31,31,31,31,124,"VU"
"Sphagnum auriculatum",0,31,31,31,31,124,"LC"
"Tomentypnum nitens",0,31,31,31,31,124,"NT"
"Campylium protensum",0,30,30,30,30,120,"LC-att"
"Dicranum fulvum",0,30,30,30,30,120,"LC-att"
"Didymodon insulanus",0,30,30,30,30,120,"LC"
"Ditrichum heteromallum",0,30,30,30,30,120,"LC"
"Drepanocladus aduncus",0,30,30,30,30,120,"LC"
"Lophocolea heterophylla",0,30,30,30,30,120,"LC"
"Lophozia silvicola",0,30,30,30,30,120,"LC-att"
"Scapania undulata",0,30,30,30,30,120,"LC"
"Syntrichia ruralis",0,30,30,30,30,120,"NE"
"Antitrichia curtipendula",0,29,29,29,29,116,"LC-att"
"Campylopus introflexus",0,29,29,29,29,116,"LC"
"Nowellia curvifolia",0,29,29,29,29,116,"LC-att"
"Pseudoamblystegium subtile",0,29,29,29,29,116,"LC-att"
"Solenostoma sphaerocarpum",0,29,29,29,29,116,"LC"
"Sphagnum obtusum",0,29,29,29,29,116,"NT"
"Anthelia julacea",0,28,28,28,28,112,"VU"
"Schistidium dupretii",0,28,28,28,28,112,"LC"
"Orthotrichum anomalum",39,18,18,18,18,111,"LC"
"Diplophyllum albicans",0,27,27,27,27,108,"LC"
"Hygrohypnella ochracea",0,27,27,27,27,108,"LC"
"Plagiothecium cavifolium",0,27,27,27,27,108,"LC"
"Pohlia nutans subsp. schimperi",0,27,27,27,27,108,"NT"
"Sciuro-hypnum reflexum",0,27,27,27,27,108,"LC"
"Brachytheciastrum velutinum",0,26,26,26,26,104,"LC"
"Calypogeia azurea",0,26,26,26,26,104,"LC"
"Calypogeia muelleriana",0,26,26,26,26,104,"LC"
"Chiloscyphus pallescens",0,26,26,26,26,104,"LC-att"
"Fuscocephaloziopsis catenulata",0,26,26,26,26,104,"NT"
"Hypnum cupressiforme var. cupressiforme",0,26,26,26,26,104,"LC"
"Nyholmiella obtusifolia",0,26,26,26,26,104,"LC"
"Radula lindenbergiana",0,26,26,26,26,104,"VU"
"Trichodon cylindricus",0,26,26,26,26,104,"LC"
"Breidleria pratensis",0,25,25,25,25,100,"LC-att"
"Coscinodon cribrosus",0,25,25,25,25,100,"LC"
"Dicranum bonjeanii",0,25,25,25,25,100,"NT"
"Fissidens dubius",0,25,25,25,25,100,"NE"
"Lophozia ventricosa",0,25,25,25,25,100,"LC"
"Metzgeria furcata",0,25,25,25,25,100,"LC"
"Plagiomnium ellipticum",0,25,25,25,25,100,"LC-att"
"Pseudoleskeella nervosa",0,25,25,25,25,100,"LC"
"Sciuro-hypnum curtum",0,25,25,25,25,100,"LC"
"Solenostoma obovatum",0,25,25,25,25,100,"LC"
"Fuscocephaloziopsis lunulifolia",0,24,24,24,24,96,"LC"
"Hypnum pallescens",0,24,24,24,24,96,"LC-att"
"Philonotis caespitosa",0,24,24,24,24,96,"LC-att"
"Schistidium robustum",0,24,24,24,24,96,"LC"
"Sphagnum fallax",0,24,24,24,24,96,"LC"
"Straminergon stramineum",0,24,24,24,24,96,"LC"
"Anastrepta orcadensis",0,23,23,23,23,92,"LC-att"
"Barbula unguiculata",0,23,23,23,23,92,"LC"
"Ctenidium molluscum",0,23,23,23,23,92,"LC"
"Dicranum flagellare",0,23,23,23,23,92,"LC-att"
"Didymodon glaucus",0,23,23,23,23,92,"VU"
"Drepanocladus polygamus",0,23,23,23,23,92,"VU"
"Homalothecium sericeum",0,23,23,23,23,92,"LC"
"Marsupella emarginata",0,23,23,23,23,92,"LC"
"Palustriella commutata",0,23,23,23,23,92,"LC"
"Plagiothecium denticulatum",0,23,23,23,23,92,"NE"
"Riccardia latifrons",0,23,23,23,23,92,"LC-att"
"Brachydontium trichodes",0,22,22,22,22,88,"LC-att"
"Calypogeia fissa",0,22,22,22,22,88,"NT"
"Plagiomnium elatum",0,22,22,22,22,88,"LC-att"
"Porella cordaeana",0,22,22,22,22,88,"NT"
"Tetraphis pellucida",0,22,22,22,22,88,"LC"
"Bryum alpinum",0,21,21,21,21,84,"NT"
"Dicranella staphylina",0,21,21,21,21,84,"LC"
"Fuscocephaloziopsis connivens",0,21,21,21,21,84,"LC"
"Grimmia ovalis",0,21,21,21,21,84,"LC"
"Plagiothecium succulentum",0,21,21,21,21,84,"LC"
"Polytrichastrum alpinum",0,21,21,21,21,84,"LC"
"Tortella pseudofragilis",0,21,21,21,21,84,"LC"
"Bazzania tricrenata",0,20,20,20,20,80,"NT"
"Cynodontium strumiferum",0,20,20,20,20,80,"LC"
"Diplophyllum obtusifolium",0,20,20,20,20,80,"LC"
"Ditrichum lineare",0,20,20,20,20,80,"LC-att"
"Encalypta streptocarpa",0,20,20,20,20,80,"LC"
"Grimmia anomala",0,20,20,20,20,80,"VU"
"Grimmia pulvinata",0,20,20,20,20,80,"LC"
"Jungermannia pumila",0,20,20,20,20,80,"NT"
"Polytrichum uliginosum",0,20,20,20,20,80,"LC-att"
"Radula complanata",0,20,20,20,20,80,"LC"
"Rhynchostegium confertum",0,20,20,20,20,80,"LC-att"
"Bryum caespiticium",0,19,19,19,19,76,"LC"
"Calliergon cordifolium",0,19,19,19,19,76,"LC"
"Calypogeia neesiana",0,19,19,19,19,76,"LC"
"Cephaloziella rubella",0,19,19,19,19,76,"LC"
"Frullania dilatata",0,19,19,19,19,76,"LC"
"Grimmia donniana",0,19,19,19,19,76,"LC"
"Plagiomnium medium",0,19,19,19,19,76,"NT"
"Plagiothecium laetum",0,19,19,19,19,76,"LC"
"Racomitrium microcarpon",0,19,19,19,19,76,"LC"
"Scapania praetervisa",0,19,19,19,19,76,"VU"
"Brachythecium mildeanum",0,18,18,18,18,72,"LC-att"
"Brachythecium rutabulum",0,18,18,18,18,72,"LC"
"Brachythecium salebrosum",0,18,18,18,18,72,"LC"
"Bryoerythrophyllum ferruginascens",0,18,18,18,18,72,"LC-att"
"Bryum capillare",0,18,18,18,18,72,"LC"
"Campylophyllopsis calcarea",0,18,18,18,18,72,"LC-att"
"Dicranella subulata",0,18,18,18,18,72,"VU"
"Diplophyllum taxifolium",0,18,18,18,18,72,"LC"
"Distichium capillaceum",0,18,18,18,18,72,"LC"
"Fissidens osmundoides",0,18,18,18,18,72,"LC-att"
"Hypnum callichroum",0,18,18,18,18,72,"EN"
"Paraleucobryum longifolium",0,18,18,18,18,72,"LC"
"Pohlia cruda",0,18,18,18,18,72,"LC"
"Pohlia ludwigii",0,18,18,18,18,72,"VU"
"Pseudoleskeella rupestris",0,18,18,18,18,72,"VU"
"Pterygoneurum ovatum",0,18,18,18,18,72,"LC"
"Pylaisia polyantha",0,18,18,18,18,72,"LC"
"Rhizomnium magnifolium",0,18,18,18,18,72,"LC-att"
"Scapania scandica",0,18,18,18,18,72,"DD"
"Schistidium confertum",0,18,18,18,18,72,"VU"
"Sphenolobus minutus",0,18,18,18,18,72,"LC"
"Taxiphyllum wissgrillii",0,18,18,18,18,72,"LC"
"Bryum",0,17,17,17,17,68,""
"Campylopus flexuosus",0,17,17,17,17,68,"LC"
"Dicranum majus",0,17,17,17,17,68,"VU"
"Fuscocephaloziopsis macrostachya",0,17,17,17,17,68,"VU"
"Harpanthus flotovianus",0,17,17,17,17,68,"VU"
"Lophoziopsis excisa",0,17,17,17,17,68,"LC-att"
"Neckera pennata",0,17,17,17,17,68,"VU"
"Orthothecium intricatum",0,17,17,17,17,68,"LC"
"Plagiothecium denticulatum var. obtusifolium",0,17,17,17,17,68,"VU"
"Pohlia wahlenbergii",0,17,17,17,17,68,"LC"
"Polytrichum commune",0,17,17,17,17,68,"LC"
"Racomitrium heterostichum",0,17,17,17,17,68,"LC"
"Rhizomnium punctatum",0,17,17,17,17,68,"LC"
"Sphagnum teres",0,17,17,17,17,68,"LC"
"Thuidium recognitum",0,17,17,17,17,68,"LC"
"Weissia longifolia",0,17,17,17,17,68,"LC"
"Anomodon longifolius",0,16,16,16,16,64,"LC"
"Bryum moravicum",0,16,16,16,16,64,"LC"
"Grimmia montana",0,16,16,16,16,64,"LC-att"
"Hypnum jutlandicum",0,16,16,16,16,64,"LC"
"Lejeunea cavifolia",0,16,16,16,16,64,"LC"
"Marsupella funckii",0,16,16,16,16,64,"NT"
"Philonotis seriata",0,16,16,16,16,64,"LC"
"Polytrichum longisetum",0,16,16,16,16,64,"LC"
"Polytrichum perigoniale",0,16,16,16,16,64,"LC"
"Pseudotaxiphyllum elegans",0,16,16,16,16,64,"LC"
"Pulvigera lyellii",0,16,16,16,16,64,"LC-att"
"Rhytidiadelphus subpinnatus",0,16,16,16,16,64,"LC-att"
"Scapania cuspiduligera",0,16,16,16,16,64,"VU"
"Schistochilopsis incisa",0,16,16,16,16,64,"LC"
"Sphagnum girgensohnii",0,16,16,16,16,64,"LC"
"Streblotrichum convolutum",0,16,16,16,16,64,"LC"
"Tortula acaulon",0,16,16,16,16,64,"NE"
"Trichostomum crispulum",0,16,16,16,16,64,"LC-att"
"Ulota bruchii",0,16,16,16,16,64,"LC"
"Aneura maxima",0,15,15,15,15,60,"NT"
"Barbilophozia hatcheri",0,15,15,15,15,60,"LC"
"Bryum argenteum",0,15,15,15,15,60,"LC"
"Fuscocephaloziopsis leucantha",0,15,15,15,15,60,"NT"
"Hymenoloma crispulum",0,15,15,15,15,60,"LC"
"Orthotrichum urnigerum",0,15,15,15,15,60,"VU"
"Plagiomnium affine",0,15,15,15,15,60,"LC"
"Pohlia elongata",0,15,15,15,15,60,"NE"
"Polytrichum piliferum",0,15,15,15,15,60,"LC"
"Rhynchostegium murale",0,15,15,15,15,60,"LC"
"Scapania uliginosa",0,15,15,15,15,60,"LC"
"Warnstorfia fluitans",0,15,15,15,15,60,"LC"
"Weissia condensa",0,15,15,15,15,60,"LC"
"Amphidium lapponicum",0,14,14,14,14,56,"EN"
"Anthoceros agrestis",0,14,14,14,14,56,"LC"
"Bartramia ithyphylla",0,14,14,14,14,56,"LC-att"
"Bryum pallens",0,14,14,14,14,56,"LC"
"Dicranum tauricum",0,14,14,14,14,56,"LC"
"Ditrichum pusillum",0,14,14,14,14,56,"LC-att"
"Fissidens pusillus",0,14,14,14,14,56,"LC-att"
"Grimmia sessitana",0,14,14,14,14,56,"VU"
"Gymnomitrion alpinum",0,14,14,14,14,56,"EN"
"Hygroamblystegium humile",0,14,14,14,14,56,"LC-att"
"Hygrohypnum luridum",0,14,14,14,14,56,"LC"
"Hypnum cupressiforme var. subjulaceum",0,14,14,14,14,56,"NT"
"Leucodon sciuroides",0,14,14,14,14,56,"LC"
"Mnium stellare",0,14,14,14,14,56,"LC"
"Orthodontium lineare",0,14,14,14,14,56,"LC"
"Platygyrium repens",0,14,14,14,14,56,"LC"
"Platyhypnum duriusculum",0,14,14,14,14,56,"NT"
"Pohlia",0,14,14,14,14,56,""
"Racomitrium aquaticum",0,14,14,14,14,56,"LC"
"Riccardia chamedryfolia",0,14,14,14,14,56,"VU"
"Sciuro-hypnum populeum",0,14,14,14,14,56,"LC"
"Solenostoma gracillimum",0,14,14,14,14,56,"LC"
"Tritomaria exsecta",0,14,14,14,14,56,"LC"
"Warnstorfia pseudostraminea",0,14,14,14,14,56,"EN"
"Anomodon viticulosus",0,13,13,13,13,52,"LC"
"Bartramia halleriana",0,13,13,13,13,52,"NT"
"Bryum elegans",0,13,13,13,13,52,"NT"
"Dicranoweisia cirrata",0,13,13,13,13,52,"LC"
"Didymodon acutus",0,13,13,13,13,52,"LC-att"
"Elodium blandowii",0,13,13,13,13,52,"EN"
"Leskea polycarpa",0,13,13,13,13,52,"LC"
"Marchantia polymorpha subsp. montivagans",0,13,13,13,13,52,"LC-att"
"Nardia geoscyphus",0,13,13,13,13,52,"LC"
"Plagiothecium nemorale",0,13,13,13,13,52,"LC"
"Pleuridium acuminatum",0,13,13,13,13,52,"LC-att"
"Pohlia annotina",0,13,13,13,13,52,"LC"
"Pohlia wahlenbergii var. glacialis",0,13,13,13,13,52,"NE"
"Pseudoleskeella catenulata",0,13,13,13,13,52,"LC"
"Pterigynandrum filiforme",0,13,13,13,13,52,"LC"
"Racomitrium aciculare",0,13,13,13,13,52,"LC"
"Racomitrium canescens",0,13,13,13,13,52,"LC"
"Scapania paludosa",0,13,13,13,13,52,"VU"
"Aulacomnium palustre",0,12,12,12,12,48,"LC"
"Bryum weigelii",0,12,12,12,12,48,"LC-att"
"Campyliadelphus chrysophyllus",0,12,12,12,12,48,"LC"
"Cratoneuron filicinum",0,12,12,12,12,48,"LC"
"Dicranella schreberiana",0,12,12,12,12,48,"LC"
"Grimmia incurva",0,12,12,12,12,48,"LC"
"Grimmia trichophylla",0,12,12,12,12,48,"LC-att"
"Harpanthus scutatus",0,12,12,12,12,48,"EN"
"Hypnum vaucheri",0,12,12,12,12,48,"LC-att"
"Jungermannia atrovirens",0,12,12,12,12,48,"VU"
"Myurella julacea",0,12,12,12,12,48,"EN"
"Odontoschisma denudatum",0,12,12,12,12,48,"LC-att"
"Orthotrichum patens",0,12,12,12,12,48,"NT"
"Oxyrrhynchium hians",0,12,12,12,12,48,"LC"
"Palustriella falcata",0,12,12,12,12,48,"LC"
"Pellia endiviifolia",0,12,12,12,12,48,"LC"
"Plagiopus oederianus",0,12,12,12,12,48,"VU"
"Pohlia drummondii",0,12,12,12,12,48,"LC"
"Scapania paludicola",0,12,12,12,12,48,"VU"
"Sphagnum russowii",0,12,12,12,12,48,"LC"
"Syntrichia virescens",0,12,12,12,12,48,"LC"
"Tortula truncata",0,12,12,12,12,48,"LC"
"Trichocolea tomentella",0,12,12,12,12,48,"LC-att"
"Weissia brachycarpa",0,12,12,12,12,48,"LC"
"Anomodon attenuatus",0,11,11,11,11,44,"LC"
"Brachythecium glareosum",0,11,11,11,11,44,"LC"
"Conocephalum salebrosum",0,11,11,11,11,44,"LC"
"Dichodontium palustre",0,11,11,11,11,44,"LC-att"
"Dichodontium pellucidum",0,11,11,11,11,44,"LC"
"Dicranodontium asperulum",0,11,11,11,11,44,"NT"
"Dicranodontium uncinatum",0,11,11,11,11,44,"EN"
"Didymodon spadiceus",0,11,11,11,11,44,"NT"
"Flexitrichum gracile",0,11,11,11,11,44,"LC-att"
"Frullania tamarisci",0,11,11,11,11,44,"NT"
"Grimmia alpestris",0,11,11,11,11,44,"VU"
"Grimmia torquata",0,11,11,11,11,44,"VU"
"Heterocladium dimorphum",0,11,11,11,11,44,"NT"
"Hylocomiastrum umbratum",0,11,11,11,11,44,"LC-att"
"Isothecium alopecuroides",0,11,11,11,11,44,"LC"
"Isothecium myosuroides",0,11,11,11,11,44,"LC-att"
"Kindbergia praelonga",0,11,11,11,11,44,"LC"
"Lepidozia reptans",0,11,11,11,11,44,"LC"
"Leptodictyum riparium",0,11,11,11,11,44,"LC"
"Plagiobryum zieri",0,11,11,11,11,44,"EN"
"Plagiothecium denticulatum var. undulatum",0,11,11,11,11,44,"LC-att"
"Polytrichum pallidisetum",0,11,11,11,11,44,"LC-att"
"Racomitrium elongatum",0,11,11,11,11,44,"LC"
"Racomitrium fasciculare",0,11,11,11,11,44,"LC"
"Scapania nemorea",0,11,11,11,11,44,"LC"
"Scapania umbrosa",0,11,11,11,11,44,"LC"
"Schistidium pruinosum",0,11,11,11,11,44,"LC-att"
"Solenostoma hyalinum",0,11,11,11,11,44,"NT"
"Syntrichia calcicola",0,11,11,11,11,44,"LC"
"Thuidium assimile",0,11,11,11,11,44,"LC"
"Tortella inclinata",0,11,11,11,11,44,"LC"
"Tortula caucasica",0,11,11,11,11,44,"LC"
"Tortula subulata",0,11,11,11,11,44,"LC"
"Trilophozia quinquedentata",0,11,11,11,11,44,"LC"
"Weissia wimmeriana",0,11,11,11,11,44,"VU"
"Anacamptodon splachnoides",0,10,10,10,10,40,"EN"
"Bryum subapiculatum",0,10,10,10,10,40,"LC"
"Calypogeia suecica",0,10,10,10,10,40,"NT"
"Cephaloziella hampeana",0,10,10,10,10,40,"LC-att"
"Cirriphyllum crassinervium",0,10,10,10,10,40,"LC"
"Dicranella varia",0,10,10,10,10,40,"LC"
"Fossombronia wondraczekii",0,10,10,10,10,40,"LC"
"Grimmia anodon",0,10,10,10,10,40,"EN"
"Lophozia ascendens",0,10,10,10,10,40,"EN"
"Lophoziopsis longidens",0,10,10,10,10,40,"NT"
"Mannia fragrans",0,10,10,10,10,40,"NT"
"Moerckia flotoviana",0,10,10,10,10,40,"CR"
"Pohlia proligera",0,10,10,10,10,40,"LC"
"Pseudocrossidium hornschuchianum",0,10,10,10,10,40,"LC"
"Pterygoneurum subsessile",0,10,10,10,10,40,"VU"
"Scapania curta",0,10,10,10,10,40,"LC"
"Schistidium brunnescens subsp. brunnescens",0,10,10,10,10,40,"LC"
"Schistidium rivulare",0,10,10,10,10,40,"LC-att"
"Thuidium delicatulum",0,10,10,10,10,40,"LC-att"
"Tortula muralis subsp. muralis var. muralis",0,10,10,10,10,40,"LC"
"Acaulon triquetrum",0,9,9,9,9,36,"VU"
"Brachythecium campestre",0,9,9,9,9,36,"LC-att"
"Brachythecium tommasinii",0,9,9,9,9,36,"LC"
"Bryum dichotomum",0,9,9,9,9,36,"LC"
"Bryum rubens",0,9,9,9,9,36,"LC"
"Calypogeia integristipula",0,9,9,9,9,36,"LC"
"Cynodontium gracilescens",0,9,9,9,9,36,"VU"
"Dicranella",0,9,9,9,9,36,""
"Didymodon ferrugineus",0,9,9,9,9,36,"LC"
"Diphyscium foliosum",0,9,9,9,9,36,"LC-att"
"Eurhynchiastrum pulchellum",0,9,9,9,9,36,"LC-att"
"Fissidens gymnandrus",0,9,9,9,9,36,"LC"
"Grimmia crinita",0,9,9,9,9,36,"EN"
"Herzogiella seligeri",0,9,9,9,9,36,"LC"
"Heterocladium heteropterum",0,9,9,9,9,36,"LC"
"Hymenostylium recurvirostrum",0,9,9,9,9,36,"VU"
"Hypnum cupressiforme",0,9,9,9,9,36,"NE"
"Lophocolea minor",0,9,9,9,9,36,"LC"
"Lophozia wenzelii",0,9,9,9,9,36,"CR"
"Orthotrichum rogeri",0,9,9,9,9,36,"VU"
"Pellia epiphylla",0,9,9,9,9,36,"LC"
"Pellia neesiana",0,9,9,9,9,36,"LC"
"Plagiothecium platyphyllum",0,9,9,9,9,36,"LC-att"
"Rhynchostegium megapolitanum",0,9,9,9,9,36,"VU"
"Scorpidium scorpioides",0,9,9,9,9,36,"EN"
"Solenostoma confertissimum",0,9,9,9,9,36,"VU"
"Sphagnum capillifolium",0,9,9,9,9,36,"LC"
"Sphagnum compactum",0,9,9,9,9,36,"LC"
"Sphagnum cuspidatum",0,9,9,9,9,36,"LC"
"Sphagnum fimbriatum",0,9,9,9,9,36,"LC"
"Sphagnum rubellum",0,9,9,9,9,36,"LC"
"Tortula lindbergii",0,9,9,9,9,36,"LC"
"Weissia controversa",0,9,9,9,9,36,"LC"
"Weissia fallax",0,9,9,9,9,36,"LC-att"
"Alleniella complanata",0,8,8,8,8,32,"LC"
"Andreaea rothii subsp. rothii",0,8,8,8,8,32,"EN"
"Barbilophozia barbata",0,8,8,8,8,32,"LC"
"Bryum pseudotriquetrum var. bimum",0,8,8,8,8,32,"LC-att"
"Campylostelium saxicola",0,8,8,8,8,32,"NT"
"Conocephalum conicum",0,8,8,8,8,32,"LC"
"Dicranella cerviculata",0,8,8,8,8,32,"LC"
"Encalypta ciliata",0,8,8,8,8,32,"VU"
"Encalypta rhaptocarpa",0,8,8,8,8,32,"NE"
"Ephemerum minutissimum",0,8,8,8,8,32,"LC"
"Eucladium verticillatum",0,8,8,8,8,32,"LC"
"Flexitrichum flexicaule",0,8,8,8,8,32,"LC"
"Grimmia longirostris",0,8,8,8,8,32,"LC"
"Heterogemma capitata",0,8,8,8,8,32,"VU"
"Homalothecium lutescens",0,8,8,8,8,32,"LC"
"Homalothecium philippeanum",0,8,8,8,8,32,"LC"
"Hygroamblystegium varium",0,8,8,8,8,32,"LC"
"Marsupella aquatica",0,8,8,8,8,32,"LC"
"Mnium marginatum",0,8,8,8,8,32,"LC"
"Mnium spinosum",0,8,8,8,8,32,"LC"
"Mylia taylorii",0,8,8,8,8,32,"LC"
"Oligotrichum hercynicum",0,8,8,8,8,32,"LC"
"Orthotrichum cupulatum var. cupulatum",0,8,8,8,8,32,"LC"
"Philonotis tomentella",0,8,8,8,8,32,"VU"
"Plagiothecium curvifolium",0,8,8,8,8,32,"LC"
"Pleuridium subulatum",0,8,8,8,8,32,"LC"
"Pseudephemerum nitidum",0,8,8,8,8,32,"LC"
"Ptilium crista-castrensis",0,8,8,8,8,32,"LC-att"
"Racomitrium affine",0,8,8,8,8,32,"LC-att"
"Racomitrium lanuginosum",0,8,8,8,8,32,"LC"
"Riccardia palmata",0,8,8,8,8,32,"LC-att"
"Sarmentypnum sarmentosum",0,8,8,8,8,32,"NT"
"Schistidium helveticum",0,8,8,8,8,32,"LC-att"
"Schistidium trichodon var. nutans",0,8,8,8,8,32,"LC-att"
"Seligeria donniana",0,8,8,8,8,32,"LC"
"Sphagnum magellanicum",0,8,8,8,8,32,"LC"
"Sphagnum platyphyllum",0,8,8,8,8,32,"CR"
"Tritomaria exsectiformis",0,8,8,8,8,32,"LC-att"
"Weissia",0,8,8,8,8,32,""
"Zygodon dentatus",0,8,8,8,8,32,"NT"
"Alleniella besseri",0,7,7,7,7,28,"LC"
"Aloina obliquifolia",0,7,7,7,7,28,"LC"
"Aloina rigida",0,7,7,7,7,28,"LC"
"Anomodon rugelii",0,7,7,7,7,28,"VU"
"Atrichum tenellum",0,7,7,7,7,28,"NT"
"Atrichum undulatum",0,7,7,7,7,28,"LC"
"Bryum creberrimum",0,7,7,7,7,28,"EN"
"Campylophyllum halleri",0,7,7,7,7,28,"EN"
"Cynodontium bruntonii",0,7,7,7,7,28,"LC-att"
"Dicranum spurium",0,7,7,7,7,28,"LC-att"
"Distichium inclinatum",0,7,7,7,7,28,"EN"
"Ditrichum zonatum",0,7,7,7,7,28,"EN"
"Endogemma caespiticia",0,7,7,7,7,28,"LC-att"
"Fissidens bryoides",0,7,7,7,7,28,"LC"
"Hylocomiastrum pyrenaicum",0,7,7,7,7,28,"VU"
"Mylia anomala",0,7,7,7,7,28,"LC"
"Paludella squarrosa",0,7,7,7,7,28,"EN"
"Philonotis calcarea",0,7,7,7,7,28,"LC-att"
"Pohlia camptotrachela",0,7,7,7,7,28,"LC-att"
"Pohlia lescuriana",0,7,7,7,7,28,"LC-att"
"Porella platyphylla",0,7,7,7,7,28,"LC"
"Preissia quadrata",0,7,7,7,7,28,"LC"
"Rhodobryum roseum",0,7,7,7,7,28,"LC"
"Rhynchostegiella tenella",0,7,7,7,7,28,"NT"
"Riccardia incurvata",0,7,7,7,7,28,"VU"
"Riccia glauca",0,7,7,7,7,28,"LC"
"Scapania aequiloba",0,7,7,7,7,28,"NT"
"Scapania subalpina",0,7,7,7,7,28,"NT"
"Scorpidium revolvens",0,7,7,7,7,28,"EN"
"Sphagnum lindbergii",0,7,7,7,7,28,"LC"
"Splachnum sphaericum",0,7,7,7,7,28,"NT"
"Syzygiella autumnalis",0,7,7,7,7,28,"VU"
"Ulota intermedia",0,7,7,7,7,28,"NE"
"Abietinella abietina",0,6,6,6,6,24,"NE"
"Aloina aloides var. ambigua",0,6,6,6,6,24,"EN"
"Anoectangium aestivum",0,6,6,6,6,24,"EN"
"Brachythecium geheebii",0,6,6,6,6,24,"EN"
"Buxbaumia aphylla",0,6,6,6,6,24,"NT"
"Buxbaumia viridis",0,6,6,6,6,24,"VU"
"Campylopus pyriformis",0,6,6,6,6,24,"LC-att"
"Cleistocarpidium palustre",0,6,6,6,6,24,"VU"
"Cynodontium",0,6,6,6,6,24,""
"Dicranella rufescens",0,6,6,6,6,24,"LC"
"Didymodon validus",0,6,6,6,6,24,"EN"
"Encalypta vulgaris",0,6,6,6,6,24,"LC"
"Geocalyx graveolens",0,6,6,6,6,24,"VU"
"Grimmia atrata",0,6,6,6,6,24,"VU"
"Grimmia orbicularis",0,6,6,6,6,24,"LC-att"
"Grimmia tergestina",0,6,6,6,6,24,"LC-att"
"Hedwigia ciliata",0,6,6,6,6,24,"LC"
"Homalia trichomanoides",0,6,6,6,6,24,"LC"
"Isopaches bicrenatus",0,6,6,6,6,24,"NT"
"Kurzia pauciflora",0,6,6,6,6,24,"VU"
"Leptobryum pyriforme",0,6,6,6,6,24,"LC"
"Lescuraea patens",0,6,6,6,6,24,"EN"
"Lescuraea radicosa",0,6,6,6,6,24,"EN"
"Leucobryum juniperoideum",0,6,6,6,6,24,"LC"
"Lewinskya rupestris",0,6,6,6,6,24,"VU"
"Lewinskya striata",0,6,6,6,6,24,"LC-att"
"Marsupella sprucei",0,6,6,6,6,24,"EN"
"Metzgeria conjugata",0,6,6,6,6,24,"LC"
"Microbryum curvicollum",0,6,6,6,6,24,"LC-att"
"Mnium hornum",0,6,6,6,6,24,"LC"
"Odontoschisma sphagni",0,6,6,6,6,24,"EN"
"Oxyrrhynchium schleicheri",0,6,6,6,6,24,"LC"
"Phaeoceros carolinianus",0,6,6,6,6,24,"LC"
"Polytrichum strictum",0,6,6,6,6,24,"LC"
"Pterygoneurum lamellatum",0,6,6,6,6,24,"EN"
"Scapania gymnostomophila",0,6,6,6,6,24,"EN"
"Schistidium",0,6,6,6,6,24,""
"Schistidium confusum",0,6,6,6,6,24,"LC-att"
"Schistidium trichodon",0,6,6,6,6,24,"NE"
"Schljakovianthus quadrilobus",0,6,6,6,6,24,"EN"
"Sphagnum squarrosum",0,6,6,6,6,24,"LC"
"Syntrichia montana",0,6,6,6,6,24,"LC"
"Syntrichia papillosa",0,6,6,6,6,24,"LC"
"Tetraplodon angustatus",0,6,6,6,6,24,"VU"
"Thamnobryum alopecurum",0,6,6,6,6,24,"LC"
"Timmia bavarica",0,6,6,6,6,24,"EN"
"Tortula muralis subsp. muralis var. aestiva",0,6,6,6,6,24,"LC"
"Tortula protobryoides",0,6,6,6,6,24,"LC-att"
"Ulota crispula",0,6,6,6,6,24,"NE"
"Andreaea frigida",0,5,5,5,5,20,"CR"
"Blindiadelphus recurvatus",0,5,5,5,5,20,"LC"
"Bryum klinggraeffii",0,5,5,5,5,20,"LC"
"Calliergonella lindbergii",0,5,5,5,5,20,"LC"
"Calypogeia sphagnicola",0,5,5,5,5,20,"NT"
"Chiloscyphus polyanthos",0,5,5,5,5,20,"LC"
"Climacium dendroides",0,5,5,5,5,20,"LC"
"Cololejeunea calcarea",0,5,5,5,5,20,"VU"
"Dicranum polysetum",0,5,5,5,5,20,"LC"
"Didymodon luridus",0,5,5,5,5,20,"NT"
"Didymodon sinuosus",0,5,5,5,5,20,"VU"
"Eurhynchium striatum",0,5,5,5,5,20,"LC-att"
"Fissidens gracilifolius",0,5,5,5,5,20,"LC"
"Fissidens taxifolius",0,5,5,5,5,20,"LC"
"Grimmia laevigata",0,5,5,5,5,20,"LC"
"Hygroamblystegium fluviatile",0,5,5,5,5,20,"LC"
"Hygroamblystegium tenax",0,5,5,5,5,20,"LC-att"
"Hypnum cupressiforme var. lacunosum",0,5,5,5,5,20,"LC"
"Kurzia sylvatica",0,5,5,5,5,20,"LC-att"
"Lophocolea bidentata",0,5,5,5,5,20,"LC-att"
"Metzgeria pubescens",0,5,5,5,5,20,"LC-att"
"Mnium thomsonii",0,5,5,5,5,20,"CR"
"Neoorthocaulis attenuatus",0,5,5,5,5,20,"LC"
"Neoorthocaulis floerkei",0,5,5,5,5,20,"LC"
"Oxyrrhynchium speciosum",0,5,5,5,5,20,"LC-att"
"Physcomitrium pyriforme",0,5,5,5,5,20,"LC"
"Plagiomnium rostratum",0,5,5,5,5,20,"LC"
"Pohlia andalusica",0,5,5,5,5,20,"LC-att"
"Ptilidium ciliare",0,5,5,5,5,20,"LC"
"Ptilidium pulcherrimum",0,5,5,5,5,20,"LC"
"Rhabdoweisia crispata",0,5,5,5,5,20,"NT"
"Rhodobryum ontariense",0,5,5,5,5,20,"LC-att"
"Rhynchostegium riparioides",0,5,5,5,5,20,"LC"
"Rhytidium rugosum",0,5,5,5,5,20,"LC"
"Scapania",0,5,5,5,5,20,""
"Schistochilopsis opacifolia",0,5,5,5,5,20,"DD-va"
"Schistostega pennata",0,5,5,5,5,20,"LC"
"Splachnum ampullaceum",0,5,5,5,5,20,"NT"
"Tayloria tenuis",0,5,5,5,5,20,"EN"
"Tetrodontium repandum",0,5,5,5,5,20,"NT"
"Thuidium tamariscinum",0,5,5,5,5,20,"LC"
"Zygodon rupestris",0,5,5,5,5,20,"NT"
"Anastrophyllum michauxii",0,4,4,4,4,16,"EN"
"Anomobryum concinnatum",0,4,4,4,4,16,"CR"
"Barbilophozia lycopodioides",0,4,4,4,4,16,"LC"
"Bartramia pomiformis",0,4,4,4,4,16,"LC"
"Brachythecium tenuicaule",0,4,4,4,4,16,"CR"
"Bryum archangelicum",0,4,4,4,4,16,"EN"
"Bryum schleicheri",0,4,4,4,4,16,"CR"
"Bryum tenuisetum",0,4,4,4,4,16,"DD"
"Bryum uliginosum",0,4,4,4,4,16,"EN"
"Bryum violaceum",0,4,4,4,4,16,"LC"
"Cephaloziella grimsulana",0,4,4,4,4,16,"EN"
"Cephaloziella spinigera",0,4,4,4,4,16,"VU"
"Cynodontium tenellum",0,4,4,4,4,16,"VU"
"Didymodon tophaceus",0,4,4,4,4,16,"LC-att"
"Eurhynchium angustirete",0,4,4,4,4,16,"LC"
"Fossombronia foveolata",0,4,4,4,4,16,"EN"
"Fuscocephaloziopsis loitlesbergeri",0,4,4,4,4,16,"VU"
"Grimmia dissimulata",0,4,4,4,4,16,"DD"
"Gymnomitrion corallioides",0,4,4,4,4,16,"CR"
"Gymnostomum viridulum",0,4,4,4,4,16,"VU"
"Haplomitrium hookeri",0,4,4,4,4,16,"CR"
"Homomallium incurvatum",0,4,4,4,4,16,"LC"
"Hygrobiella laxifolia",0,4,4,4,4,16,"VU"
"Liochlaena lanceolata",0,4,4,4,4,16,"NT"
"Mesoptychia badensis",0,4,4,4,4,16,"VU"
"Metzgeria violacea",0,4,4,4,4,16,"VU"
"Nardia compressa",0,4,4,4,4,16,"VU"
"Orthotrichum",0,4,4,4,4,16,""
"Oxymitra incrassata",0,4,4,4,4,16,"EN"
"Oxyrrhynchium hians var. rigidum",0,4,4,4,4,16,"NE"
"Pedinophyllum interruptum",0,4,4,4,4,16,"LC-att"
"Physcomitrium sphaericum",0,4,4,4,4,16,"VU"
"Plagiochila asplenioides",0,4,4,4,4,16,"LC"
"Plasteurhynchium striatulum",0,4,4,4,4,16,"LC-att"
"Pogonatum urnigerum",0,4,4,4,4,16,"LC"
"Pohlia bulbifera",0,4,4,4,4,16,"LC"
"Pottiopsis caespitosa",0,4,4,4,4,16,"CR"
"Pyramidula tetragona",0,4,4,4,4,16,"CR"
"Racomitrium macounii subsp. macounii",0,4,4,4,4,16,"EN"
"Reboulia hemisphaerica",0,4,4,4,4,16,"NT"
"Rhytidiadelphus squarrosus",0,4,4,4,4,16,"LC"
"Riccia sorocarpa",0,4,4,4,4,16,"LC"
"Scapania mucronata",0,4,4,4,4,16,"DD"
"Schistidium elegantulum subsp. elegantulum",0,4,4,4,4,16,"LC-att"
"Schistidium lancifolium",0,4,4,4,4,16,"LC-att"
"Schljakovia kunzeana",0,4,4,4,4,16,"EN"
"Seligeria",0,4,4,4,4,16,""
"Seligeria calcarea",0,4,4,4,4,16,"EN"
"Serpoleskea confervoides",0,4,4,4,4,16,"LC-att"
"Sphagnum angustifolium",0,4,4,4,4,16,"LC-att"
"Sphagnum quinquefarium",0,4,4,4,4,16,"LC"
"Tetralophozia setiformis",0,4,4,4,4,16,"VU"
"Tortula acaulon var. pilifera",0,4,4,4,4,16,"LC"
"Tortula atrovirens",0,4,4,4,4,16,"CR"
"Tortula inermis",0,4,4,4,4,16,"CR"
"Asterella saccata",0,3,3,3,3,12,"EN"
"Aulacomnium androgynum",0,3,3,3,3,12,"LC"
"Blasia pusilla",0,3,3,3,3,12,"LC"
"Brachythecium albicans",0,3,3,3,3,12,"LC"
"Callicladium haldanianum",0,3,3,3,3,12,"VU"
"Cephaloziella elachista",0,3,3,3,3,12,"EN"
"Cirriphyllum piliferum",0,3,3,3,3,12,"LC"
"Conardia compacta",0,3,3,3,3,12,"EN"
"Crossocalyx hellerianus",0,3,3,3,3,12,"EN"
"Dicranum elongatum",0,3,3,3,3,12,"EN"
"Dicranum fuscescens",0,3,3,3,3,12,"LC"
"Didymodon umbrosus",0,3,3,3,3,12,"NE"
"Entodon concinnus",0,3,3,3,3,12,"LC-att"
"Fissidens viridulus",0,3,3,3,3,12,"NE"
"Frullania inflata",0,3,3,3,3,12,"EN"
"Fuscocephaloziopsis pleniceps",0,3,3,3,3,12,"VU"
"Hedwigia ciliata var. leucophaea",0,3,3,3,3,12,"NE"
"Hennediella heimii",0,3,3,3,3,12,"DD-va"
"Hookeria lucens",0,3,3,3,3,12,"NT"
"Hypnum fertile",0,3,3,3,3,12,"CR"
"Isopterygiopsis pulchella",0,3,3,3,3,12,"CR"
"Lescuraea mutabilis",0,3,3,3,3,12,"EN"
"Lescuraea plicata",0,3,3,3,3,12,"EN"
"Leucobryum glaucum",0,3,3,3,3,12,"LC"
"Mannia gracilis",0,3,3,3,3,12,"EN"
"Marchantia polymorpha subsp. ruderalis",0,3,3,3,3,12,"LC"
"Marsupella sparsifolia",0,3,3,3,3,12,"CR"
"Mesoptychia heterocolpos",0,3,3,3,3,12,"CR"
"Obtusifolium obtusum",0,3,3,3,3,12,"EN"
"Orthotrichum scanicum",0,3,3,3,3,12,"CR"
"Pellia",0,3,3,3,3,12,""
"Plagiomnium cuspidatum",0,3,3,3,3,12,"LC"
"Plagiomnium undulatum",0,3,3,3,3,12,"LC"
"Pleurozium schreberi",0,3,3,3,3,12,"LC"
"Pseudobryum cinclidioides",0,3,3,3,3,12,"EN"
"Pseudocrossidium revolutum",0,3,3,3,3,12,"EN"
"Rhytidiadelphus loreus",0,3,3,3,3,12,"LC"
"Riccia crinita",0,3,3,3,3,12,"NE"
"Riccia fluitans",0,3,3,3,3,12,"LC"
"Riccia gougetiana",0,3,3,3,3,12,"NE"
"Saelania glaucescens",0,3,3,3,3,12,"EN"
"Seligeria pusilla",0,3,3,3,3,12,"VU"
"Sphagnum",0,3,3,3,3,12,""
"Sphagnum fuscum",0,3,3,3,3,12,"NT"
"Sphagnum majus",0,3,3,3,3,12,"LC"
"Syntrichia fragilis",0,3,3,3,3,12,"CR"
"Syntrichia latifolia",0,3,3,3,3,12,"NT"
"Syntrichia ruralis var. ruraliformis",0,3,3,3,3,12,"LC-att"
"Tetraplodon mnioides",0,3,3,3,3,12,"VU"
"Tetrodontium brownianum",0,3,3,3,3,12,"NT"
"Tortella squarrosa",0,3,3,3,3,12,"NT"
"Ulota crispa",0,3,3,3,3,12,"LC"
"Lewinskya affinis var. bohemica",6,1,1,1,1,10,"DD"
"Acaulon muticum",0,2,2,2,2,8,"LC-att"
"Andreaea crassinervia",0,2,2,2,2,8,"CR"
"Brachythecium",0,2,2,2,2,8,""
"Bryum gemmiferum",0,2,2,2,2,8,"LC-att"
"Bryum intermedium",0,2,2,2,2,8,"CR"
"Bryum mildeanum",0,2,2,2,2,8,"VU"
"Campylopus fragilis",0,2,2,2,2,8,"LC-att"
"Campylopus subulatus",0,2,2,2,2,8,"VU"
"Ceratodon conicus",0,2,2,2,2,8,"NE"
"Cololejeunea rossettiana",0,2,2,2,2,8,"VU"
"Dicranum muehlenbeckii",0,2,2,2,2,8,"CR"
"Entosthodon fascicularis",0,2,2,2,2,8,"VU"
"Entosthodon pulchellus",0,2,2,2,2,8,"EN"
"Fontinalis antipyretica",0,2,2,2,2,8,"LC"
"Fontinalis squamosa",0,2,2,2,2,8,"LC"
"Funaria hygrometrica",0,2,2,2,2,8,"LC"
"Grimmia caespiticia",0,2,2,2,2,8,"DD"
"Hypnum imponens",0,2,2,2,2,8,"CR"
"Kiaeria falcata",0,2,2,2,2,8,"EN"
"Loeskeobryum brevirostre",0,2,2,2,2,8,"NT"
"Marchantia polymorpha subsp. polymorpha",0,2,2,2,2,8,"LC"
"Meesia triquetra",0,2,2,2,2,8,"CR"
"Mnium spinulosum",0,2,2,2,2,8,"LC"
"Moerckia blyttii",0,2,2,2,2,8,"EN"
"Orthotrichum pulchellum",0,2,2,2,2,8,"LC-att"
"Orthotrichum schimperi",0,2,2,2,2,8,"NE"
"Orthotrichum stellatum",0,2,2,2,2,8,"CR"
"Philonotis capillaris",0,2,2,2,2,8,"EN"
"Pogonatum aloides",0,2,2,2,2,8,"LC"
"Pogonatum nanum",0,2,2,2,2,8,"VU"
"Pterygoneurum kozlovii",0,2,2,2,2,8,"NE"
"Rhizomnium pseudopunctatum",0,2,2,2,2,8,"EN"
"Ricciocarpos natans",0,2,2,2,2,8,"NT"
"Scapania aspera",0,2,2,2,2,8,"VU"
"Scapania parvifolia",0,2,2,2,2,8,"CR"
"Sphagnum inundatum",0,2,2,2,2,8,"DD"
"Sphagnum tenellum",0,2,2,2,2,8,"LC"
"Sphenolobus saxicola",0,2,2,2,2,8,"VU"
"Streblotrichum commutatum",0,2,2,2,2,8,"DD"
"Thamnobryum neckeroides",0,2,2,2,2,8,"EN"
"Tortula hoppeana",0,2,2,2,2,8,"EN"
"Tortula schimperi",0,2,2,2,2,8,"DD"
"Weissia rutilans",0,2,2,2,2,8,"EN"
"Anthelia juratzkana",0,1,1,1,1,4,"CR"
"Anthoceros neesii",0,1,1,1,1,4,"EN"
"Archidium alternifolium",0,1,1,1,1,4,"CR"
"Atrichum angustatum",0,1,1,1,1,4,"EN"
"Bazzania flaccida",0,1,1,1,1,4,"VU"
"Bazzania trilobata var. depauperata",0,1,1,1,1,4,"NE"
"Brachythecium capillaceum",0,1,1,1,1,4,"DD-va"
"Bryum cyclophyllum",0,1,1,1,1,4,"EN"
"Bryum funkii",0,1,1,1,1,4,"DD"
"Bryum ruderale",0,1,1,1,1,4,"DD"
"Bryum turbinatum",0,1,1,1,1,4,"EN"
"Calypogeia",0,1,1,1,1,4,""
"Campyliadelphus elodes",0,1,1,1,1,4,"DD-va"
"Cinclidotus riparius",0,1,1,1,1,4,"VU"
"Crossidium squamiferum",0,1,1,1,1,4,"CR"
"Dicranella humilis",0,1,1,1,1,4,"VU"
"Dicranum",0,1,1,1,1,4,""
"Dicranum spadiceum",0,1,1,1,1,4,"CR"
"Dicranum undulatum",0,1,1,1,1,4,"LC-att"
"Didymodon sicculus",0,1,1,1,1,4,"NE"
"Didymodon vinealis",0,1,1,1,1,4,"EN"
"Discelium nudum",0,1,1,1,1,4,"VU"
"Ditrichum",0,1,1,1,1,4,""
"Drepanocladus sendtneri",0,1,1,1,1,4,"CR"
"Encalypta",0,1,1,1,1,4,""
"Ephemerum serratum",0,1,1,1,1,4,"DD"
"Fissidens bambergeri",0,1,1,1,1,4,"EN"
"Fissidens dubius var. mucronatus",0,1,1,1,1,4,"LC"
"Fissidens exilis",0,1,1,1,1,4,"LC"
"Fissidens viridulus var. incurvus",0,1,1,1,1,4,"LC-att"
"Fontinalis hypnoides",0,1,1,1,1,4,"EN"
"Fossombronia",0,1,1,1,1,4,""
"Grimmia elatior",0,1,1,1,1,4,"CR"
"Grimmia teretinervis",0,1,1,1,1,4,"CR"
"Gymnostomum",0,1,1,1,1,4,""
"Gyroweisia tenuis",0,1,1,1,1,4,"DD"
"Hilpertia velenovskyi",0,1,1,1,1,4,"CR"
"Hydrogonium croceum",0,1,1,1,1,4,"CR"
"Hylocomium splendens",0,1,1,1,1,4,"LC"
"Hypnum cupressiforme var. heseleri",0,1,1,1,1,4,"DD"
"Isopterygiopsis muelleriana",0,1,1,1,1,4,"CR"
"Mannia",0,1,1,1,1,4,""
"Meesia uliginosa",0,1,1,1,1,4,"CR"
"Microbryum floerkeanum",0,1,1,1,1,4,"VU"
"Microlejeunea ulicina",0,1,1,1,1,4,"CR"
"Orthocaulis atlanticus",0,1,1,1,1,4,"RE"
"Philonotis",0,1,1,1,1,4,""
"Physcomitrella patens",0,1,1,1,1,4,"LC-att"
"Physcomitrium",0,1,1,1,1,4,""
"Physcomitrium eurystomum",0,1,1,1,1,4,"VU"
"Plagiothecium latebricola",0,1,1,1,1,4,"VU"
"Plagiothecium neckeroideum",0,1,1,1,1,4,"EN"
"Plagiothecium undulatum",0,1,1,1,1,4,"LC"
"Platydictya jungermannioides",0,1,1,1,1,4,"CR"
"Pohlia andrewsii",0,1,1,1,1,4,"NE"
"Pohlia elongata var. greenii",0,1,1,1,1,4,"NE"
"Pohlia lutescens",0,1,1,1,1,4,"DD"
"Pohlia melanodon",0,1,1,1,1,4,"VU"
"Pohlia wahlenbergii var. calcarea",0,1,1,1,1,4,"NE"
"Polytrichum juniperinum",0,1,1,1,1,4,"LC"
"Porella arboris-vitae",0,1,1,1,1,4,"NT"
"Pseudoleskeella tectorum",0,1,1,1,1,4,"CR"
"Pseudoscleropodium purum",0,1,1,1,1,4,"LC"
"Racomitrium ericoides",0,1,1,1,1,4,"NE"
"Rhabdoweisia crenulata",0,1,1,1,1,4,"EN"
"Rhynchostegiella teneriffae",0,1,1,1,1,4,"EN"
"Rhynchostegium rotundifolium",0,1,1,1,1,4,"EN"
"Rhytidiadelphus triquetrus",0,1,1,1,1,4,"LC"
"Riccia ciliata",0,1,1,1,1,4,"NT"
"Riccia ciliifera",0,1,1,1,1,4,"NT"
"Riccia papillosa",0,1,1,1,1,4,"CR"
"Scapania apiculata",0,1,1,1,1,4,"CR"
"Scapania helvetica",0,1,1,1,1,4,"CR"
"Scapania lingulata",0,1,1,1,1,4,"EN"
"Schistidium brunnescens",0,1,1,1,1,4,"LC"
"Schistochilopsis grandiretis",0,1,1,1,1,4,"VU"
"Sciuro-hypnum flotowianum",0,1,1,1,1,4,"DD"
"Seligeria acutifolia",0,1,1,1,1,4,"VU"
"Sphagnum riparium",0,1,1,1,1,4,"LC"
"Syntrichia",0,1,1,1,1,4,""
"Syntrichia montana var. calva",0,1,1,1,1,4,"NE"
"Tayloria",0,1,1,1,1,4,""
"Tayloria serrata",0,1,1,1,1,4,"EN"
"Timmia austriaca",0,1,1,1,1,4,"RE"
"Tortella",0,1,1,1,1,4,""
"Tortula mucronifolia",0,1,1,1,1,4,"CR"
"Ulota",0,1,1,1,1,4,""
"Ulota coarctata",0,1,1,1,1,4,"CR"
"Weissia squarrosa",0,1,1,1,1,4,"VU"
"Zygodon viridissimus",0,1,1,1,1,4,"EN"
"Orthotrichum alpestre",1,0,0,0,0,1,"CR"
